datum;wahl;ags;gebiet-nr;gebiet-name;max-schnellmeldungen;anz-schnellmeldungen;A1;A2;A3;A;B;B1;C;D;D1;D2
06.11.2022;Bürgerentscheid zur Abwahl des Oberbürgermeisters der Stadt Frankfurt am Main, Herrn Peter Feldmann;06412000;NA;Altstadt;3;3;942;242;49;1233;293;74;2;291;239;52
06.11.2022;Bürgerentscheid zur Abwahl des Oberbürgermeisters der Stadt Frankfurt am Main, Herrn Peter Feldmann;06412000;NA;Bergen-Enkheim;15;14;4394;1462;269;6125;2343;492;28;2315;2044;271
06.11.2022;Bürgerentscheid zur Abwahl des Oberbürgermeisters der Stadt Frankfurt am Main, Herrn Peter Feldmann;06412000;NA;Berkersheim;3;3;693;215;54;962;271;62;3;268;222;46
06.11.2022;Bürgerentscheid zur Abwahl des Oberbürgermeisters der Stadt Frankfurt am Main, Herrn Peter Feldmann;06412000;NA;Bockenheim;32;14;3630;1199;247;5076;1465;417;16;1449;1225;224
06.11.2022;Bürgerentscheid zur Abwahl des Oberbürgermeisters der Stadt Frankfurt am Main, Herrn Peter Feldmann;06412000;NA;Bonames;5;5;1288;546;74;1908;462;135;3;459;402;57
06.11.2022;Bürgerentscheid zur Abwahl des Oberbürgermeisters der Stadt Frankfurt am Main, Herrn Peter Feldmann;06412000;NA;Bornheim;26;14;3321;1578;243;5142;1906;494;19;1887;1549;338
06.11.2022;Bürgerentscheid zur Abwahl des Oberbürgermeisters der Stadt Frankfurt am Main, Herrn Peter Feldmann;06412000;NA;Dornbusch;18;14;3036;816;255;4107;1325;393;13;1312;1087;225
06.11.2022;Bürgerentscheid zur Abwahl des Oberbürgermeisters der Stadt Frankfurt am Main, Herrn Peter Feldmann;06412000;NA;Eckenheim;11;11;2735;1105;155;3995;1383;297;10;1373;1175;198
06.11.2022;Bürgerentscheid zur Abwahl des Oberbürgermeisters der Stadt Frankfurt am Main, Herrn Peter Feldmann;06412000;NA;Eschersheim;12;12;3708;1312;200;5220;1807;364;14;1793;1529;264
06.11.2022;Bürgerentscheid zur Abwahl des Oberbürgermeisters der Stadt Frankfurt am Main, Herrn Peter Feldmann;06412000;NA;Fechenheim;11;11;1839;751;118;2708;718;162;6;712;581;131
06.11.2022;Bürgerentscheid zur Abwahl des Oberbürgermeisters der Stadt Frankfurt am Main, Herrn Peter Feldmann;06412000;NA;Frankfurter Berg;6;6;1283;477;115;1875;517;110;5;512;443;69
06.11.2022;Bürgerentscheid zur Abwahl des Oberbürgermeisters der Stadt Frankfurt am Main, Herrn Peter Feldmann;06412000;NA;Gallus;26;13;2733;851;203;3787;1279;259;10;1269;1113;156
06.11.2022;Bürgerentscheid zur Abwahl des Oberbürgermeisters der Stadt Frankfurt am Main, Herrn Peter Feldmann;06412000;NA;Ginnheim;12;12;3010;852;195;4057;1306;279;10;1296;1100;196
06.11.2022;Bürgerentscheid zur Abwahl des Oberbürgermeisters der Stadt Frankfurt am Main, Herrn Peter Feldmann;06412000;NA;Griesheim;15;12;2514;627;154;3295;783;187;9;774;672;102
06.11.2022;Bürgerentscheid zur Abwahl des Oberbürgermeisters der Stadt Frankfurt am Main, Herrn Peter Feldmann;06412000;NA;Gutleut- und Bahnhofsviertel;8;8;1542;458;125;2125;535;101;6;529;467;62
06.11.2022;Bürgerentscheid zur Abwahl des Oberbürgermeisters der Stadt Frankfurt am Main, Herrn Peter Feldmann;06412000;NA;Harheim;5;5;1285;590;114;1989;489;91;5;484;408;76
06.11.2022;Bürgerentscheid zur Abwahl des Oberbürgermeisters der Stadt Frankfurt am Main, Herrn Peter Feldmann;06412000;NA;Hausen;5;5;1175;548;110;1833;537;148;5;532;458;74
06.11.2022;Bürgerentscheid zur Abwahl des Oberbürgermeisters der Stadt Frankfurt am Main, Herrn Peter Feldmann;06412000;NA;Heddernheim;14;14;3069;1204;232;4505;1646;504;15;1631;1422;209
06.11.2022;Bürgerentscheid zur Abwahl des Oberbürgermeisters der Stadt Frankfurt am Main, Herrn Peter Feldmann;06412000;NA;Höchst;10;10;1414;496;99;2009;510;133;4;506;415;91
06.11.2022;Bürgerentscheid zur Abwahl des Oberbürgermeisters der Stadt Frankfurt am Main, Herrn Peter Feldmann;06412000;NA;Innenstadt;5;5;670;238;36;944;279;57;2;277;243;34
06.11.2022;Bürgerentscheid zur Abwahl des Oberbürgermeisters der Stadt Frankfurt am Main, Herrn Peter Feldmann;06412000;NA;Kalbach-Riedberg;15;12;3430;982;192;4604;1134;253;10;1124;961;163
06.11.2022;Bürgerentscheid zur Abwahl des Oberbürgermeisters der Stadt Frankfurt am Main, Herrn Peter Feldmann;06412000;NA;Nied;13;13;2620;841;220;3681;983;185;11;972;819;153
06.11.2022;Bürgerentscheid zur Abwahl des Oberbürgermeisters der Stadt Frankfurt am Main, Herrn Peter Feldmann;06412000;NA;Nieder-Erlenbach;5;5;1456;502;78;2036;473;129;5;468;386;82
06.11.2022;Bürgerentscheid zur Abwahl des Oberbürgermeisters der Stadt Frankfurt am Main, Herrn Peter Feldmann;06412000;NA;Nieder-Eschbach;9;9;2168;823;116;3107;1121;233;11;1110;916;194
06.11.2022;Bürgerentscheid zur Abwahl des Oberbürgermeisters der Stadt Frankfurt am Main, Herrn Peter Feldmann;06412000;NA;Niederrad;18;16;3723;1231;291;5245;1960;586;19;1941;1644;297
06.11.2022;Bürgerentscheid zur Abwahl des Oberbürgermeisters der Stadt Frankfurt am Main, Herrn Peter Feldmann;06412000;NA;Niederursel;11;11;2411;873;157;3441;1195;323;13;1182;1022;160
06.11.2022;Bürgerentscheid zur Abwahl des Oberbürgermeisters der Stadt Frankfurt am Main, Herrn Peter Feldmann;06412000;NA;Nordend-Ost;20;12;3513;1402;319;5234;1936;399;21;1915;1627;288
06.11.2022;Bürgerentscheid zur Abwahl des Oberbürgermeisters der Stadt Frankfurt am Main, Herrn Peter Feldmann;06412000;NA;Nordend-West;28;13;3177;907;254;4338;1011;296;9;1002;866;136
06.11.2022;Bürgerentscheid zur Abwahl des Oberbürgermeisters der Stadt Frankfurt am Main, Herrn Peter Feldmann;06412000;NA;Oberrad;9;9;2230;1008;158;3396;1245;327;14;1231;1011;220
06.11.2022;Bürgerentscheid zur Abwahl des Oberbürgermeisters der Stadt Frankfurt am Main, Herrn Peter Feldmann;06412000;NA;Ostend;26;13;2464;1023;161;3648;1064;312;8;1056;864;192
06.11.2022;Bürgerentscheid zur Abwahl des Oberbürgermeisters der Stadt Frankfurt am Main, Herrn Peter Feldmann;06412000;NA;Praunheim;14;14;3173;1342;189;4704;1769;530;13;1756;1490;266
06.11.2022;Bürgerentscheid zur Abwahl des Oberbürgermeisters der Stadt Frankfurt am Main, Herrn Peter Feldmann;06412000;NA;Preungesheim;11;11;2385;944;188;3517;1129;349;8;1121;992;129
06.11.2022;Bürgerentscheid zur Abwahl des Oberbürgermeisters der Stadt Frankfurt am Main, Herrn Peter Feldmann;06412000;NA;Riederwald;3;3;686;307;57;1050;296;69;3;293;245;48
06.11.2022;Bürgerentscheid zur Abwahl des Oberbürgermeisters der Stadt Frankfurt am Main, Herrn Peter Feldmann;06412000;NA;Rödelheim;14;13;3560;947;229;4736;1726;500;18;1708;1438;270
06.11.2022;Bürgerentscheid zur Abwahl des Oberbürgermeisters der Stadt Frankfurt am Main, Herrn Peter Feldmann;06412000;NA;Sachsenhausen-Nord;27;14;4146;1073;260;5479;2067;561;18;2049;1674;375
06.11.2022;Bürgerentscheid zur Abwahl des Oberbürgermeisters der Stadt Frankfurt am Main, Herrn Peter Feldmann;06412000;NA;Sachsenhausen-Süd und Flughafen;24;16;3106;1307;178;4591;1621;437;14;1607;1420;187
06.11.2022;Bürgerentscheid zur Abwahl des Oberbürgermeisters der Stadt Frankfurt am Main, Herrn Peter Feldmann;06412000;NA;Schwanheim;17;15;3108;946;186;4240;1054;291;11;1043;879;164
06.11.2022;Bürgerentscheid zur Abwahl des Oberbürgermeisters der Stadt Frankfurt am Main, Herrn Peter Feldmann;06412000;NA;Seckbach;10;10;1519;561;98;2178;713;211;8;705;577;128
06.11.2022;Bürgerentscheid zur Abwahl des Oberbürgermeisters der Stadt Frankfurt am Main, Herrn Peter Feldmann;06412000;NA;Sindlingen;6;6;1187;380;97;1664;511;118;4;507;426;81
06.11.2022;Bürgerentscheid zur Abwahl des Oberbürgermeisters der Stadt Frankfurt am Main, Herrn Peter Feldmann;06412000;NA;Sossenheim;11;11;1740;610;156;2506;826;251;6;820;677;143
06.11.2022;Bürgerentscheid zur Abwahl des Oberbürgermeisters der Stadt Frankfurt am Main, Herrn Peter Feldmann;06412000;NA;Unterliederbach;11;11;2738;730;139;3607;1312;339;14;1298;1114;184
06.11.2022;Bürgerentscheid zur Abwahl des Oberbürgermeisters der Stadt Frankfurt am Main, Herrn Peter Feldmann;06412000;NA;Westend-Nord;8;8;1541;461;93;2095;647;175;6;641;554;87
06.11.2022;Bürgerentscheid zur Abwahl des Oberbürgermeisters der Stadt Frankfurt am Main, Herrn Peter Feldmann;06412000;NA;Westend-Süd;15;15;4251;1773;383;6407;2253;427;22;2231;1888;343
06.11.2022;Bürgerentscheid zur Abwahl des Oberbürgermeisters der Stadt Frankfurt am Main, Herrn Peter Feldmann;06412000;NA;Zeilsheim;8;8;1724;601;150;2475;897;226;8;889;766;123
