datum;wahl;ags;gebiet-nr;gebiet-name;max-schnellmeldungen;anz-schnellmeldungen;A1;A2;A3;A;B;B1;C;D;D1;D2
06.11.2022;Bürgerentscheid zur Abwahl des Oberbürgermeisters der Stadt Frankfurt am Main, Herrn Peter Feldmann;06412000;NA;Altstadt;3;3;942;242;49;1233;293;74;2;291;239;52
06.11.2022;Bürgerentscheid zur Abwahl des Oberbürgermeisters der Stadt Frankfurt am Main, Herrn Peter Feldmann;06412000;NA;Bergen-Enkheim;15;6;1984;703;130;2817;933;264;9;924;761;163
06.11.2022;Bürgerentscheid zur Abwahl des Oberbürgermeisters der Stadt Frankfurt am Main, Herrn Peter Feldmann;06412000;NA;Berkersheim;3;3;693;215;54;962;271;62;3;268;222;46
06.11.2022;Bürgerentscheid zur Abwahl des Oberbürgermeisters der Stadt Frankfurt am Main, Herrn Peter Feldmann;06412000;NA;Bockenheim;32;5;1124;543;107;1774;620;172;6;614;524;90
06.11.2022;Bürgerentscheid zur Abwahl des Oberbürgermeisters der Stadt Frankfurt am Main, Herrn Peter Feldmann;06412000;NA;Bonames;5;5;1288;546;74;1908;462;135;3;459;402;57
06.11.2022;Bürgerentscheid zur Abwahl des Oberbürgermeisters der Stadt Frankfurt am Main, Herrn Peter Feldmann;06412000;NA;Bornheim;26;4;1094;370;63;1527;497;139;5;492;433;59
06.11.2022;Bürgerentscheid zur Abwahl des Oberbürgermeisters der Stadt Frankfurt am Main, Herrn Peter Feldmann;06412000;NA;Dornbusch;18;6;1292;356;67;1715;401;77;4;397;343;54
06.11.2022;Bürgerentscheid zur Abwahl des Oberbürgermeisters der Stadt Frankfurt am Main, Herrn Peter Feldmann;06412000;NA;Eckenheim;11;5;1300;605;101;2006;493;93;5;488;432;56
06.11.2022;Bürgerentscheid zur Abwahl des Oberbürgermeisters der Stadt Frankfurt am Main, Herrn Peter Feldmann;06412000;NA;Eschersheim;12;6;1990;591;164;2745;874;181;8;866;769;97
06.11.2022;Bürgerentscheid zur Abwahl des Oberbürgermeisters der Stadt Frankfurt am Main, Herrn Peter Feldmann;06412000;NA;Fechenheim;11;5;920;309;64;1293;385;82;4;381;324;57
06.11.2022;Bürgerentscheid zur Abwahl des Oberbürgermeisters der Stadt Frankfurt am Main, Herrn Peter Feldmann;06412000;NA;Frankfurter Berg;6;6;1283;477;115;1875;517;110;5;512;443;69
06.11.2022;Bürgerentscheid zur Abwahl des Oberbürgermeisters der Stadt Frankfurt am Main, Herrn Peter Feldmann;06412000;NA;Gallus;26;4;791;336;54;1181;340;83;3;337;290;47
06.11.2022;Bürgerentscheid zur Abwahl des Oberbürgermeisters der Stadt Frankfurt am Main, Herrn Peter Feldmann;06412000;NA;Ginnheim;12;6;1641;451;125;2217;849;159;8;841;690;151
06.11.2022;Bürgerentscheid zur Abwahl des Oberbürgermeisters der Stadt Frankfurt am Main, Herrn Peter Feldmann;06412000;NA;Griesheim;15;6;1181;316;69;1566;569;139;5;564;483;81
06.11.2022;Bürgerentscheid zur Abwahl des Oberbürgermeisters der Stadt Frankfurt am Main, Herrn Peter Feldmann;06412000;NA;Gutleut- und Bahnhofsviertel;8;5;1084;293;57;1434;463;93;5;458;390;68
06.11.2022;Bürgerentscheid zur Abwahl des Oberbürgermeisters der Stadt Frankfurt am Main, Herrn Peter Feldmann;06412000;NA;Harheim;5;5;1285;590;114;1989;489;91;5;484;408;76
06.11.2022;Bürgerentscheid zur Abwahl des Oberbürgermeisters der Stadt Frankfurt am Main, Herrn Peter Feldmann;06412000;NA;Hausen;5;5;1175;548;110;1833;537;148;5;532;458;74
06.11.2022;Bürgerentscheid zur Abwahl des Oberbürgermeisters der Stadt Frankfurt am Main, Herrn Peter Feldmann;06412000;NA;Heddernheim;14;6;1358;476;93;1927;546;133;6;540;453;87
06.11.2022;Bürgerentscheid zur Abwahl des Oberbürgermeisters der Stadt Frankfurt am Main, Herrn Peter Feldmann;06412000;NA;Höchst;10;5;738;249;58;1045;372;109;3;369;312;57
06.11.2022;Bürgerentscheid zur Abwahl des Oberbürgermeisters der Stadt Frankfurt am Main, Herrn Peter Feldmann;06412000;NA;Innenstadt;5;5;670;238;36;944;279;57;2;277;243;34
06.11.2022;Bürgerentscheid zur Abwahl des Oberbürgermeisters der Stadt Frankfurt am Main, Herrn Peter Feldmann;06412000;NA;Kalbach-Riedberg;15;4;1155;316;63;1534;473;129;5;468;393;75
06.11.2022;Bürgerentscheid zur Abwahl des Oberbürgermeisters der Stadt Frankfurt am Main, Herrn Peter Feldmann;06412000;NA;Nied;13;5;1050;321;64;1435;504;121;4;500;418;82
06.11.2022;Bürgerentscheid zur Abwahl des Oberbürgermeisters der Stadt Frankfurt am Main, Herrn Peter Feldmann;06412000;NA;Nieder-Erlenbach;5;5;1456;502;78;2036;473;129;5;468;386;82
06.11.2022;Bürgerentscheid zur Abwahl des Oberbürgermeisters der Stadt Frankfurt am Main, Herrn Peter Feldmann;06412000;NA;Nieder-Eschbach;9;4;1015;383;73;1471;460;116;3;457;379;78
06.11.2022;Bürgerentscheid zur Abwahl des Oberbürgermeisters der Stadt Frankfurt am Main, Herrn Peter Feldmann;06412000;NA;Niederrad;18;6;1246;420;93;1759;534;157;6;528;458;70
06.11.2022;Bürgerentscheid zur Abwahl des Oberbürgermeisters der Stadt Frankfurt am Main, Herrn Peter Feldmann;06412000;NA;Niederursel;11;4;779;316;53;1148;345;73;3;342;295;47
06.11.2022;Bürgerentscheid zur Abwahl des Oberbürgermeisters der Stadt Frankfurt am Main, Herrn Peter Feldmann;06412000;NA;Nordend-Ost;20;6;1919;627;157;2703;975;223;8;967;849;118
06.11.2022;Bürgerentscheid zur Abwahl des Oberbürgermeisters der Stadt Frankfurt am Main, Herrn Peter Feldmann;06412000;NA;Nordend-West;28;6;1459;579;95;2133;731;139;8;723;633;90
06.11.2022;Bürgerentscheid zur Abwahl des Oberbürgermeisters der Stadt Frankfurt am Main, Herrn Peter Feldmann;06412000;NA;Oberrad;9;5;1329;492;102;1923;627;186;6;621;540;81
06.11.2022;Bürgerentscheid zur Abwahl des Oberbürgermeisters der Stadt Frankfurt am Main, Herrn Peter Feldmann;06412000;NA;Ostend;26;6;1266;446;67;1779;607;119;5;602;512;90
06.11.2022;Bürgerentscheid zur Abwahl des Oberbürgermeisters der Stadt Frankfurt am Main, Herrn Peter Feldmann;06412000;NA;Praunheim;14;6;1606;427;105;2138;744;191;6;738;631;107
06.11.2022;Bürgerentscheid zur Abwahl des Oberbürgermeisters der Stadt Frankfurt am Main, Herrn Peter Feldmann;06412000;NA;Preungesheim;11;6;1266;618;106;1990;751;164;7;744;656;88
06.11.2022;Bürgerentscheid zur Abwahl des Oberbürgermeisters der Stadt Frankfurt am Main, Herrn Peter Feldmann;06412000;NA;Riederwald;3;3;686;307;57;1050;296;69;3;293;245;48
06.11.2022;Bürgerentscheid zur Abwahl des Oberbürgermeisters der Stadt Frankfurt am Main, Herrn Peter Feldmann;06412000;NA;Rödelheim;14;5;1087;448;84;1619;462;106;4;458;402;56
06.11.2022;Bürgerentscheid zur Abwahl des Oberbürgermeisters der Stadt Frankfurt am Main, Herrn Peter Feldmann;06412000;NA;Sachsenhausen-Nord;27;5;1479;425;96;2000;552;119;5;547;481;66
06.11.2022;Bürgerentscheid zur Abwahl des Oberbürgermeisters der Stadt Frankfurt am Main, Herrn Peter Feldmann;06412000;NA;Sachsenhausen-Süd und Flughafen;24;6;1310;356;72;1738;526;104;5;521;463;58
06.11.2022;Bürgerentscheid zur Abwahl des Oberbürgermeisters der Stadt Frankfurt am Main, Herrn Peter Feldmann;06412000;NA;Schwanheim;17;6;1139;525;75;1739;595;149;4;591;508;83
06.11.2022;Bürgerentscheid zur Abwahl des Oberbürgermeisters der Stadt Frankfurt am Main, Herrn Peter Feldmann;06412000;NA;Seckbach;10;6;993;273;76;1342;359;78;3;356;315;41
06.11.2022;Bürgerentscheid zur Abwahl des Oberbürgermeisters der Stadt Frankfurt am Main, Herrn Peter Feldmann;06412000;NA;Sindlingen;6;5;991;456;62;1509;536;149;6;530;441;89
06.11.2022;Bürgerentscheid zur Abwahl des Oberbürgermeisters der Stadt Frankfurt am Main, Herrn Peter Feldmann;06412000;NA;Sossenheim;11;6;914;439;73;1426;513;108;4;509;436;73
06.11.2022;Bürgerentscheid zur Abwahl des Oberbürgermeisters der Stadt Frankfurt am Main, Herrn Peter Feldmann;06412000;NA;Unterliederbach;11;5;1106;384;62;1552;541;106;4;537;445;92
06.11.2022;Bürgerentscheid zur Abwahl des Oberbürgermeisters der Stadt Frankfurt am Main, Herrn Peter Feldmann;06412000;NA;Westend-Nord;8;6;1082;361;67;1510;581;114;6;575;489;86
06.11.2022;Bürgerentscheid zur Abwahl des Oberbürgermeisters der Stadt Frankfurt am Main, Herrn Peter Feldmann;06412000;NA;Westend-Süd;15;6;1890;518;136;2544;879;235;7;872;719;153
06.11.2022;Bürgerentscheid zur Abwahl des Oberbürgermeisters der Stadt Frankfurt am Main, Herrn Peter Feldmann;06412000;NA;Zeilsheim;8;5;1087;380;81;1548;453;116;3;450;385;65
