datum;wahl;ags;gebiet-nr;gebiet-name;max-schnellmeldungen;anz-schnellmeldungen;A1;A2;A3;A;B;B1;C;D;D1;D2
06.11.2022;Bürgerentscheid zur Abwahl des Oberbürgermeisters der Stadt Frankfurt am Main, Herrn Peter Feldmann;06412000;NA;Altstadt;3;3;942;242;49;1233;293;74;2;291;239;52
06.11.2022;Bürgerentscheid zur Abwahl des Oberbürgermeisters der Stadt Frankfurt am Main, Herrn Peter Feldmann;06412000;NA;Bergen-Enkheim;15;3;1047;317;89;1453;354;90;3;351;291;60
06.11.2022;Bürgerentscheid zur Abwahl des Oberbürgermeisters der Stadt Frankfurt am Main, Herrn Peter Feldmann;06412000;NA;Berkersheim;3;2;531;163;33;727;264;66;2;262;229;33
06.11.2022;Bürgerentscheid zur Abwahl des Oberbürgermeisters der Stadt Frankfurt am Main, Herrn Peter Feldmann;06412000;NA;Bockenheim;32;2;471;130;34;635;204;63;1;203;169;34
06.11.2022;Bürgerentscheid zur Abwahl des Oberbürgermeisters der Stadt Frankfurt am Main, Herrn Peter Feldmann;06412000;NA;Bonames;5;2;529;231;40;800;222;59;2;220;182;38
06.11.2022;Bürgerentscheid zur Abwahl des Oberbürgermeisters der Stadt Frankfurt am Main, Herrn Peter Feldmann;06412000;NA;Bornheim;26;2;492;209;40;741;172;52;1;171;151;20
06.11.2022;Bürgerentscheid zur Abwahl des Oberbürgermeisters der Stadt Frankfurt am Main, Herrn Peter Feldmann;06412000;NA;Dornbusch;18;3;624;226;52;902;212;47;1;211;180;31
06.11.2022;Bürgerentscheid zur Abwahl des Oberbürgermeisters der Stadt Frankfurt am Main, Herrn Peter Feldmann;06412000;NA;Eckenheim;11;3;823;330;48;1201;465;95;3;462;380;82
06.11.2022;Bürgerentscheid zur Abwahl des Oberbürgermeisters der Stadt Frankfurt am Main, Herrn Peter Feldmann;06412000;NA;Eschersheim;12;3;868;427;85;1380;469;139;5;464;381;83
06.11.2022;Bürgerentscheid zur Abwahl des Oberbürgermeisters der Stadt Frankfurt am Main, Herrn Peter Feldmann;06412000;NA;Fechenheim;11;2;418;118;25;561;155;36;1;154;132;22
06.11.2022;Bürgerentscheid zur Abwahl des Oberbürgermeisters der Stadt Frankfurt am Main, Herrn Peter Feldmann;06412000;NA;Frankfurter Berg;6;3;637;176;49;862;222;64;1;221;186;35
06.11.2022;Bürgerentscheid zur Abwahl des Oberbürgermeisters der Stadt Frankfurt am Main, Herrn Peter Feldmann;06412000;NA;Gallus;26;3;659;207;56;922;327;73;3;324;270;54
06.11.2022;Bürgerentscheid zur Abwahl des Oberbürgermeisters der Stadt Frankfurt am Main, Herrn Peter Feldmann;06412000;NA;Ginnheim;12;3;724;310;67;1101;305;64;2;303;269;34
06.11.2022;Bürgerentscheid zur Abwahl des Oberbürgermeisters der Stadt Frankfurt am Main, Herrn Peter Feldmann;06412000;NA;Griesheim;15;3;564;175;37;776;287;79;2;285;243;42
06.11.2022;Bürgerentscheid zur Abwahl des Oberbürgermeisters der Stadt Frankfurt am Main, Herrn Peter Feldmann;06412000;NA;Gutleut- und Bahnhofsviertel;8;3;628;168;33;829;319;68;3;316;275;41
06.11.2022;Bürgerentscheid zur Abwahl des Oberbürgermeisters der Stadt Frankfurt am Main, Herrn Peter Feldmann;06412000;NA;Harheim;5;3;844;366;79;1289;304;58;3;301;259;42
06.11.2022;Bürgerentscheid zur Abwahl des Oberbürgermeisters der Stadt Frankfurt am Main, Herrn Peter Feldmann;06412000;NA;Hausen;5;2;499;164;40;703;179;47;1;178;149;29
06.11.2022;Bürgerentscheid zur Abwahl des Oberbürgermeisters der Stadt Frankfurt am Main, Herrn Peter Feldmann;06412000;NA;Heddernheim;14;3;688;193;37;918;224;60;2;222;182;40
06.11.2022;Bürgerentscheid zur Abwahl des Oberbürgermeisters der Stadt Frankfurt am Main, Herrn Peter Feldmann;06412000;NA;Höchst;10;3;439;175;26;640;227;62;2;225;199;26
06.11.2022;Bürgerentscheid zur Abwahl des Oberbürgermeisters der Stadt Frankfurt am Main, Herrn Peter Feldmann;06412000;NA;Innenstadt;5;3;435;135;36;606;225;61;2;223;198;25
06.11.2022;Bürgerentscheid zur Abwahl des Oberbürgermeisters der Stadt Frankfurt am Main, Herrn Peter Feldmann;06412000;NA;Kalbach-Riedberg;15;1;310;89;25;424;99;28;1;98;87;11
06.11.2022;Bürgerentscheid zur Abwahl des Oberbürgermeisters der Stadt Frankfurt am Main, Herrn Peter Feldmann;06412000;NA;Nied;13;3;677;179;55;911;306;68;2;304;266;38
06.11.2022;Bürgerentscheid zur Abwahl des Oberbürgermeisters der Stadt Frankfurt am Main, Herrn Peter Feldmann;06412000;NA;Nieder-Erlenbach;5;2;550;236;40;826;249;50;2;247;207;40
06.11.2022;Bürgerentscheid zur Abwahl des Oberbürgermeisters der Stadt Frankfurt am Main, Herrn Peter Feldmann;06412000;NA;Nieder-Eschbach;9;3;824;262;62;1148;359;72;3;356;291;65
06.11.2022;Bürgerentscheid zur Abwahl des Oberbürgermeisters der Stadt Frankfurt am Main, Herrn Peter Feldmann;06412000;NA;Niederrad;18;3;596;218;52;866;272;69;2;270;221;49
06.11.2022;Bürgerentscheid zur Abwahl des Oberbürgermeisters der Stadt Frankfurt am Main, Herrn Peter Feldmann;06412000;NA;Niederursel;11;2;365;143;25;533;168;50;1;167;145;22
06.11.2022;Bürgerentscheid zur Abwahl des Oberbürgermeisters der Stadt Frankfurt am Main, Herrn Peter Feldmann;06412000;NA;Nordend-Ost;20;3;891;417;77;1385;380;109;3;377;310;67
06.11.2022;Bürgerentscheid zur Abwahl des Oberbürgermeisters der Stadt Frankfurt am Main, Herrn Peter Feldmann;06412000;NA;Nordend-West;28;3;726;243;38;1007;308;71;2;306;258;48
06.11.2022;Bürgerentscheid zur Abwahl des Oberbürgermeisters der Stadt Frankfurt am Main, Herrn Peter Feldmann;06412000;NA;Oberrad;9;3;763;280;63;1106;408;107;4;404;346;58
06.11.2022;Bürgerentscheid zur Abwahl des Oberbürgermeisters der Stadt Frankfurt am Main, Herrn Peter Feldmann;06412000;NA;Ostend;26;3;689;214;39;942;343;88;2;341;295;46
06.11.2022;Bürgerentscheid zur Abwahl des Oberbürgermeisters der Stadt Frankfurt am Main, Herrn Peter Feldmann;06412000;NA;Praunheim;14;3;715;273;38;1026;327;101;3;324;283;41
06.11.2022;Bürgerentscheid zur Abwahl des Oberbürgermeisters der Stadt Frankfurt am Main, Herrn Peter Feldmann;06412000;NA;Preungesheim;11;3;763;290;49;1102;383;76;4;379;333;46
06.11.2022;Bürgerentscheid zur Abwahl des Oberbürgermeisters der Stadt Frankfurt am Main, Herrn Peter Feldmann;06412000;NA;Riederwald;3;3;686;307;57;1050;296;69;3;293;245;48
06.11.2022;Bürgerentscheid zur Abwahl des Oberbürgermeisters der Stadt Frankfurt am Main, Herrn Peter Feldmann;06412000;NA;Rödelheim;14;3;687;267;48;1002;267;79;2;265;224;41
06.11.2022;Bürgerentscheid zur Abwahl des Oberbürgermeisters der Stadt Frankfurt am Main, Herrn Peter Feldmann;06412000;NA;Sachsenhausen-Nord;27;3;824;371;68;1263;332;66;2;330;284;46
06.11.2022;Bürgerentscheid zur Abwahl des Oberbürgermeisters der Stadt Frankfurt am Main, Herrn Peter Feldmann;06412000;NA;Sachsenhausen-Süd und Flughafen;24;3;648;162;43;853;203;47;2;201;169;32
06.11.2022;Bürgerentscheid zur Abwahl des Oberbürgermeisters der Stadt Frankfurt am Main, Herrn Peter Feldmann;06412000;NA;Schwanheim;17;3;612;261;47;920;331;83;3;328;285;43
06.11.2022;Bürgerentscheid zur Abwahl des Oberbürgermeisters der Stadt Frankfurt am Main, Herrn Peter Feldmann;06412000;NA;Seckbach;10;3;433;170;34;637;190;37;2;188;156;32
06.11.2022;Bürgerentscheid zur Abwahl des Oberbürgermeisters der Stadt Frankfurt am Main, Herrn Peter Feldmann;06412000;NA;Sindlingen;6;3;614;205;42;861;255;70;2;253;206;47
06.11.2022;Bürgerentscheid zur Abwahl des Oberbürgermeisters der Stadt Frankfurt am Main, Herrn Peter Feldmann;06412000;NA;Sossenheim;11;3;504;139;28;671;239;53;2;237;209;28
06.11.2022;Bürgerentscheid zur Abwahl des Oberbürgermeisters der Stadt Frankfurt am Main, Herrn Peter Feldmann;06412000;NA;Unterliederbach;11;2;392;127;31;550;141;42;1;140;119;21
06.11.2022;Bürgerentscheid zur Abwahl des Oberbürgermeisters der Stadt Frankfurt am Main, Herrn Peter Feldmann;06412000;NA;Westend-Nord;8;3;555;150;45;750;207;40;1;206;170;36
06.11.2022;Bürgerentscheid zur Abwahl des Oberbürgermeisters der Stadt Frankfurt am Main, Herrn Peter Feldmann;06412000;NA;Westend-Süd;15;3;789;350;48;1187;358;103;3;355;312;43
06.11.2022;Bürgerentscheid zur Abwahl des Oberbürgermeisters der Stadt Frankfurt am Main, Herrn Peter Feldmann;06412000;NA;Zeilsheim;8;3;573;271;45;889;280;58;2;278;238;40
