datum;wahl;ags;gebiet-nr;gebiet-name;max-schnellmeldungen;anz-schnellmeldungen;A1;A2;A3;A;B;B1;C;D;D1;D2
06.11.2022;Bürgerentscheid zur Abwahl des Oberbürgermeisters der Stadt Frankfurt am Main, Herrn Peter Feldmann;06412000;NA;Altstadt;3;3;942;242;49;1233;293;74;2;291;239;52
06.11.2022;Bürgerentscheid zur Abwahl des Oberbürgermeisters der Stadt Frankfurt am Main, Herrn Peter Feldmann;06412000;NA;Bergen-Enkheim;15;8;2697;883;153;3733;1050;289;12;1038;869;169
06.11.2022;Bürgerentscheid zur Abwahl des Oberbürgermeisters der Stadt Frankfurt am Main, Herrn Peter Feldmann;06412000;NA;Berkersheim;3;3;693;215;54;962;271;62;3;268;222;46
06.11.2022;Bürgerentscheid zur Abwahl des Oberbürgermeisters der Stadt Frankfurt am Main, Herrn Peter Feldmann;06412000;NA;Bockenheim;32;6;1428;522;82;2032;618;169;6;612;521;91
06.11.2022;Bürgerentscheid zur Abwahl des Oberbürgermeisters der Stadt Frankfurt am Main, Herrn Peter Feldmann;06412000;NA;Bonames;5;5;1288;546;74;1908;462;135;3;459;402;57
06.11.2022;Bürgerentscheid zur Abwahl des Oberbürgermeisters der Stadt Frankfurt am Main, Herrn Peter Feldmann;06412000;NA;Bornheim;26;6;1467;689;90;2246;830;242;7;823;725;98
06.11.2022;Bürgerentscheid zur Abwahl des Oberbürgermeisters der Stadt Frankfurt am Main, Herrn Peter Feldmann;06412000;NA;Dornbusch;18;8;1783;478;105;2366;701;182;7;694;588;106
06.11.2022;Bürgerentscheid zur Abwahl des Oberbürgermeisters der Stadt Frankfurt am Main, Herrn Peter Feldmann;06412000;NA;Eckenheim;11;7;2006;596;122;2724;1006;308;9;997;818;179
06.11.2022;Bürgerentscheid zur Abwahl des Oberbürgermeisters der Stadt Frankfurt am Main, Herrn Peter Feldmann;06412000;NA;Eschersheim;12;8;2537;998;163;3698;1143;350;13;1130;960;170
06.11.2022;Bürgerentscheid zur Abwahl des Oberbürgermeisters der Stadt Frankfurt am Main, Herrn Peter Feldmann;06412000;NA;Fechenheim;11;7;1163;540;78;1781;485;149;4;481;414;67
06.11.2022;Bürgerentscheid zur Abwahl des Oberbürgermeisters der Stadt Frankfurt am Main, Herrn Peter Feldmann;06412000;NA;Frankfurter Berg;6;6;1283;477;115;1875;517;110;5;512;443;69
06.11.2022;Bürgerentscheid zur Abwahl des Oberbürgermeisters der Stadt Frankfurt am Main, Herrn Peter Feldmann;06412000;NA;Gallus;26;6;1097;499;78;1674;394;80;3;391;337;54
06.11.2022;Bürgerentscheid zur Abwahl des Oberbürgermeisters der Stadt Frankfurt am Main, Herrn Peter Feldmann;06412000;NA;Ginnheim;12;8;2120;597;152;2869;821;244;9;812;684;128
06.11.2022;Bürgerentscheid zur Abwahl des Oberbürgermeisters der Stadt Frankfurt am Main, Herrn Peter Feldmann;06412000;NA;Griesheim;15;7;1403;388;103;1894;454;129;4;450;392;58
06.11.2022;Bürgerentscheid zur Abwahl des Oberbürgermeisters der Stadt Frankfurt am Main, Herrn Peter Feldmann;06412000;NA;Gutleut- und Bahnhofsviertel;8;7;1332;531;104;1967;658;133;5;653;540;113
06.11.2022;Bürgerentscheid zur Abwahl des Oberbürgermeisters der Stadt Frankfurt am Main, Herrn Peter Feldmann;06412000;NA;Harheim;5;5;1285;590;114;1989;489;91;5;484;408;76
06.11.2022;Bürgerentscheid zur Abwahl des Oberbürgermeisters der Stadt Frankfurt am Main, Herrn Peter Feldmann;06412000;NA;Hausen;5;5;1175;548;110;1833;537;148;5;532;458;74
06.11.2022;Bürgerentscheid zur Abwahl des Oberbürgermeisters der Stadt Frankfurt am Main, Herrn Peter Feldmann;06412000;NA;Heddernheim;14;7;1666;558;105;2329;762;209;6;756;665;91
06.11.2022;Bürgerentscheid zur Abwahl des Oberbürgermeisters der Stadt Frankfurt am Main, Herrn Peter Feldmann;06412000;NA;Höchst;10;7;997;388;72;1457;505;147;3;502;440;62
06.11.2022;Bürgerentscheid zur Abwahl des Oberbürgermeisters der Stadt Frankfurt am Main, Herrn Peter Feldmann;06412000;NA;Innenstadt;5;5;670;238;36;944;279;57;2;277;243;34
06.11.2022;Bürgerentscheid zur Abwahl des Oberbürgermeisters der Stadt Frankfurt am Main, Herrn Peter Feldmann;06412000;NA;Kalbach-Riedberg;15;5;1480;363;79;1922;456;131;5;451;377;74
06.11.2022;Bürgerentscheid zur Abwahl des Oberbürgermeisters der Stadt Frankfurt am Main, Herrn Peter Feldmann;06412000;NA;Nied;13;6;1320;327;83;1730;496;124;4;492;419;73
06.11.2022;Bürgerentscheid zur Abwahl des Oberbürgermeisters der Stadt Frankfurt am Main, Herrn Peter Feldmann;06412000;NA;Nieder-Erlenbach;5;5;1456;502;78;2036;473;129;5;468;386;82
06.11.2022;Bürgerentscheid zur Abwahl des Oberbürgermeisters der Stadt Frankfurt am Main, Herrn Peter Feldmann;06412000;NA;Nieder-Eschbach;9;6;1531;618;137;2286;687;209;5;682;592;90
06.11.2022;Bürgerentscheid zur Abwahl des Oberbürgermeisters der Stadt Frankfurt am Main, Herrn Peter Feldmann;06412000;NA;Niederrad;18;8;1561;740;115;2416;902;198;10;892;726;166
06.11.2022;Bürgerentscheid zur Abwahl des Oberbürgermeisters der Stadt Frankfurt am Main, Herrn Peter Feldmann;06412000;NA;Niederursel;11;6;1234;368;101;1703;443;134;5;438;389;49
06.11.2022;Bürgerentscheid zur Abwahl des Oberbürgermeisters der Stadt Frankfurt am Main, Herrn Peter Feldmann;06412000;NA;Nordend-Ost;20;7;2175;780;171;3126;788;195;6;782;682;100
06.11.2022;Bürgerentscheid zur Abwahl des Oberbürgermeisters der Stadt Frankfurt am Main, Herrn Peter Feldmann;06412000;NA;Nordend-West;28;8;2104;624;146;2874;809;216;6;803;698;105
06.11.2022;Bürgerentscheid zur Abwahl des Oberbürgermeisters der Stadt Frankfurt am Main, Herrn Peter Feldmann;06412000;NA;Oberrad;9;6;1631;604;108;2343;635;121;6;629;534;95
06.11.2022;Bürgerentscheid zur Abwahl des Oberbürgermeisters der Stadt Frankfurt am Main, Herrn Peter Feldmann;06412000;NA;Ostend;26;6;1266;446;67;1779;607;119;5;602;512;90
06.11.2022;Bürgerentscheid zur Abwahl des Oberbürgermeisters der Stadt Frankfurt am Main, Herrn Peter Feldmann;06412000;NA;Praunheim;14;7;1599;672;133;2404;777;238;8;769;633;136
06.11.2022;Bürgerentscheid zur Abwahl des Oberbürgermeisters der Stadt Frankfurt am Main, Herrn Peter Feldmann;06412000;NA;Preungesheim;11;8;1839;600;110;2549;626;176;5;621;518;103
06.11.2022;Bürgerentscheid zur Abwahl des Oberbürgermeisters der Stadt Frankfurt am Main, Herrn Peter Feldmann;06412000;NA;Riederwald;3;3;686;307;57;1050;296;69;3;293;245;48
06.11.2022;Bürgerentscheid zur Abwahl des Oberbürgermeisters der Stadt Frankfurt am Main, Herrn Peter Feldmann;06412000;NA;Rödelheim;14;7;1642;639;132;2413;629;149;6;623;535;88
06.11.2022;Bürgerentscheid zur Abwahl des Oberbürgermeisters der Stadt Frankfurt am Main, Herrn Peter Feldmann;06412000;NA;Sachsenhausen-Nord;27;7;1848;784;158;2790;825;236;8;817;713;104
06.11.2022;Bürgerentscheid zur Abwahl des Oberbürgermeisters der Stadt Frankfurt am Main, Herrn Peter Feldmann;06412000;NA;Sachsenhausen-Süd und Flughafen;24;8;1595;611;115;2321;731;170;8;723;590;133
06.11.2022;Bürgerentscheid zur Abwahl des Oberbürgermeisters der Stadt Frankfurt am Main, Herrn Peter Feldmann;06412000;NA;Schwanheim;17;8;1640;565;88;2293;665;153;5;660;556;104
06.11.2022;Bürgerentscheid zur Abwahl des Oberbürgermeisters der Stadt Frankfurt am Main, Herrn Peter Feldmann;06412000;NA;Seckbach;10;8;1322;350;91;1763;495;134;6;489;401;88
06.11.2022;Bürgerentscheid zur Abwahl des Oberbürgermeisters der Stadt Frankfurt am Main, Herrn Peter Feldmann;06412000;NA;Sindlingen;6;6;1187;380;97;1664;511;118;4;507;426;81
06.11.2022;Bürgerentscheid zur Abwahl des Oberbürgermeisters der Stadt Frankfurt am Main, Herrn Peter Feldmann;06412000;NA;Sossenheim;11;8;1359;423;87;1869;699;170;7;692;611;81
06.11.2022;Bürgerentscheid zur Abwahl des Oberbürgermeisters der Stadt Frankfurt am Main, Herrn Peter Feldmann;06412000;NA;Unterliederbach;11;6;1311;520;79;1910;728;137;5;723;589;134
06.11.2022;Bürgerentscheid zur Abwahl des Oberbürgermeisters der Stadt Frankfurt am Main, Herrn Peter Feldmann;06412000;NA;Westend-Nord;8;8;1541;461;93;2095;647;175;6;641;554;87
06.11.2022;Bürgerentscheid zur Abwahl des Oberbürgermeisters der Stadt Frankfurt am Main, Herrn Peter Feldmann;06412000;NA;Westend-Süd;15;8;2410;820;177;3407;821;256;7;814;719;95
06.11.2022;Bürgerentscheid zur Abwahl des Oberbürgermeisters der Stadt Frankfurt am Main, Herrn Peter Feldmann;06412000;NA;Zeilsheim;8;6;1204;517;112;1833;426;79;4;422;364;58
