datum;wahl;ags;gebiet-nr;gebiet-name;max-schnellmeldungen;anz-schnellmeldungen;A1;A2;A3;A;B;B1;C;D;D1;D2
06.11.2022;Bürgerentscheid zur Abwahl des Oberbürgermeisters der Stadt Frankfurt am Main, Herrn Peter Feldmann;06412000;NA;Altstadt;3;3;942;242;49;1233;293;74;2;291;239;52
06.11.2022;Bürgerentscheid zur Abwahl des Oberbürgermeisters der Stadt Frankfurt am Main, Herrn Peter Feldmann;06412000;NA;Bergen-Enkheim;15;4;1208;533;97;1838;603;140;6;597;506;91
06.11.2022;Bürgerentscheid zur Abwahl des Oberbürgermeisters der Stadt Frankfurt am Main, Herrn Peter Feldmann;06412000;NA;Berkersheim;3;3;693;215;54;962;271;62;3;268;222;46
06.11.2022;Bürgerentscheid zur Abwahl des Oberbürgermeisters der Stadt Frankfurt am Main, Herrn Peter Feldmann;06412000;NA;Bockenheim;32;3;764;202;40;1006;261;66;2;259;228;31
06.11.2022;Bürgerentscheid zur Abwahl des Oberbürgermeisters der Stadt Frankfurt am Main, Herrn Peter Feldmann;06412000;NA;Bonames;5;3;824;255;42;1121;408;97;3;405;334;71
06.11.2022;Bürgerentscheid zur Abwahl des Oberbürgermeisters der Stadt Frankfurt am Main, Herrn Peter Feldmann;06412000;NA;Bornheim;26;3;796;284;57;1137;331;71;3;328;273;55
06.11.2022;Bürgerentscheid zur Abwahl des Oberbürgermeisters der Stadt Frankfurt am Main, Herrn Peter Feldmann;06412000;NA;Dornbusch;18;4;745;343;52;1140;379;94;3;376;313;63
06.11.2022;Bürgerentscheid zur Abwahl des Oberbürgermeisters der Stadt Frankfurt am Main, Herrn Peter Feldmann;06412000;NA;Eckenheim;11;4;1196;384;70;1650;448;125;3;445;362;83
06.11.2022;Bürgerentscheid zur Abwahl des Oberbürgermeisters der Stadt Frankfurt am Main, Herrn Peter Feldmann;06412000;NA;Eschersheim;12;4;1340;486;88;1914;710;198;7;703;602;101
06.11.2022;Bürgerentscheid zur Abwahl des Oberbürgermeisters der Stadt Frankfurt am Main, Herrn Peter Feldmann;06412000;NA;Fechenheim;11;3;568;225;41;834;279;56;2;277;236;41
06.11.2022;Bürgerentscheid zur Abwahl des Oberbürgermeisters der Stadt Frankfurt am Main, Herrn Peter Feldmann;06412000;NA;Frankfurter Berg;6;4;897;280;60;1237;319;77;2;317;262;55
06.11.2022;Bürgerentscheid zur Abwahl des Oberbürgermeisters der Stadt Frankfurt am Main, Herrn Peter Feldmann;06412000;NA;Gallus;26;4;791;336;54;1181;340;83;3;337;290;47
06.11.2022;Bürgerentscheid zur Abwahl des Oberbürgermeisters der Stadt Frankfurt am Main, Herrn Peter Feldmann;06412000;NA;Ginnheim;12;4;937;438;59;1434;466;94;5;461;410;51
06.11.2022;Bürgerentscheid zur Abwahl des Oberbürgermeisters der Stadt Frankfurt am Main, Herrn Peter Feldmann;06412000;NA;Griesheim;15;4;676;315;47;1038;322;99;3;319;277;42
06.11.2022;Bürgerentscheid zur Abwahl des Oberbürgermeisters der Stadt Frankfurt am Main, Herrn Peter Feldmann;06412000;NA;Gutleut- und Bahnhofsviertel;8;4;781;277;56;1114;278;59;2;276;235;41
06.11.2022;Bürgerentscheid zur Abwahl des Oberbürgermeisters der Stadt Frankfurt am Main, Herrn Peter Feldmann;06412000;NA;Harheim;5;4;1198;482;81;1761;458;131;5;453;371;82
06.11.2022;Bürgerentscheid zur Abwahl des Oberbürgermeisters der Stadt Frankfurt am Main, Herrn Peter Feldmann;06412000;NA;Hausen;5;3;836;250;63;1149;386;79;3;383;312;71
06.11.2022;Bürgerentscheid zur Abwahl des Oberbürgermeisters der Stadt Frankfurt am Main, Herrn Peter Feldmann;06412000;NA;Heddernheim;14;4;818;364;75;1257;296;80;3;293;259;34
06.11.2022;Bürgerentscheid zur Abwahl des Oberbürgermeisters der Stadt Frankfurt am Main, Herrn Peter Feldmann;06412000;NA;Höchst;10;3;439;175;26;640;227;62;2;225;199;26
06.11.2022;Bürgerentscheid zur Abwahl des Oberbürgermeisters der Stadt Frankfurt am Main, Herrn Peter Feldmann;06412000;NA;Innenstadt;5;4;539;183;29;751;182;40;1;181;151;30
06.11.2022;Bürgerentscheid zur Abwahl des Oberbürgermeisters der Stadt Frankfurt am Main, Herrn Peter Feldmann;06412000;NA;Kalbach-Riedberg;15;2;582;150;37;769;266;66;2;264;231;33
06.11.2022;Bürgerentscheid zur Abwahl des Oberbürgermeisters der Stadt Frankfurt am Main, Herrn Peter Feldmann;06412000;NA;Nied;13;3;677;179;55;911;306;68;2;304;266;38
06.11.2022;Bürgerentscheid zur Abwahl des Oberbürgermeisters der Stadt Frankfurt am Main, Herrn Peter Feldmann;06412000;NA;Nieder-Erlenbach;5;3;768;358;72;1198;417;111;3;414;348;66
06.11.2022;Bürgerentscheid zur Abwahl des Oberbürgermeisters der Stadt Frankfurt am Main, Herrn Peter Feldmann;06412000;NA;Nieder-Eschbach;9;4;1015;383;73;1471;460;116;3;457;379;78
06.11.2022;Bürgerentscheid zur Abwahl des Oberbürgermeisters der Stadt Frankfurt am Main, Herrn Peter Feldmann;06412000;NA;Niederrad;18;4;755;306;42;1103;354;74;2;352;311;41
06.11.2022;Bürgerentscheid zur Abwahl des Oberbürgermeisters der Stadt Frankfurt am Main, Herrn Peter Feldmann;06412000;NA;Niederursel;11;3;617;185;47;849;255;54;2;253;219;34
06.11.2022;Bürgerentscheid zur Abwahl des Oberbürgermeisters der Stadt Frankfurt am Main, Herrn Peter Feldmann;06412000;NA;Nordend-Ost;20;4;1260;560;96;1916;501;139;3;498;429;69
06.11.2022;Bürgerentscheid zur Abwahl des Oberbürgermeisters der Stadt Frankfurt am Main, Herrn Peter Feldmann;06412000;NA;Nordend-West;28;4;1071;277;66;1414;370;110;3;367;301;66
06.11.2022;Bürgerentscheid zur Abwahl des Oberbürgermeisters der Stadt Frankfurt am Main, Herrn Peter Feldmann;06412000;NA;Oberrad;9;3;763;280;63;1106;408;107;4;404;346;58
06.11.2022;Bürgerentscheid zur Abwahl des Oberbürgermeisters der Stadt Frankfurt am Main, Herrn Peter Feldmann;06412000;NA;Ostend;26;4;832;376;48;1256;354;84;3;351;287;64
06.11.2022;Bürgerentscheid zur Abwahl des Oberbürgermeisters der Stadt Frankfurt am Main, Herrn Peter Feldmann;06412000;NA;Praunheim;14;4;1082;304;60;1446;420;110;3;417;360;57
06.11.2022;Bürgerentscheid zur Abwahl des Oberbürgermeisters der Stadt Frankfurt am Main, Herrn Peter Feldmann;06412000;NA;Preungesheim;11;4;926;405;61;1392;347;82;3;344;304;40
06.11.2022;Bürgerentscheid zur Abwahl des Oberbürgermeisters der Stadt Frankfurt am Main, Herrn Peter Feldmann;06412000;NA;Riederwald;3;3;686;307;57;1050;296;69;3;293;245;48
06.11.2022;Bürgerentscheid zur Abwahl des Oberbürgermeisters der Stadt Frankfurt am Main, Herrn Peter Feldmann;06412000;NA;Rödelheim;14;4;877;402;49;1328;358;95;4;354;314;40
06.11.2022;Bürgerentscheid zur Abwahl des Oberbürgermeisters der Stadt Frankfurt am Main, Herrn Peter Feldmann;06412000;NA;Sachsenhausen-Nord;27;3;824;371;68;1263;332;66;2;330;284;46
06.11.2022;Bürgerentscheid zur Abwahl des Oberbürgermeisters der Stadt Frankfurt am Main, Herrn Peter Feldmann;06412000;NA;Sachsenhausen-Süd und Flughafen;24;4;736;316;64;1116;298;56;3;295;247;48
06.11.2022;Bürgerentscheid zur Abwahl des Oberbürgermeisters der Stadt Frankfurt am Main, Herrn Peter Feldmann;06412000;NA;Schwanheim;17;4;821;341;68;1230;356;83;2;354;305;49
06.11.2022;Bürgerentscheid zur Abwahl des Oberbürgermeisters der Stadt Frankfurt am Main, Herrn Peter Feldmann;06412000;NA;Seckbach;10;4;656;165;35;856;205;52;1;204;170;34
06.11.2022;Bürgerentscheid zur Abwahl des Oberbürgermeisters der Stadt Frankfurt am Main, Herrn Peter Feldmann;06412000;NA;Sindlingen;6;4;878;253;61;1192;345;66;3;342;293;49
06.11.2022;Bürgerentscheid zur Abwahl des Oberbürgermeisters der Stadt Frankfurt am Main, Herrn Peter Feldmann;06412000;NA;Sossenheim;11;4;667;261;37;965;238;73;2;236;209;27
06.11.2022;Bürgerentscheid zur Abwahl des Oberbürgermeisters der Stadt Frankfurt am Main, Herrn Peter Feldmann;06412000;NA;Unterliederbach;11;3;627;218;43;888;330;103;3;327;285;42
06.11.2022;Bürgerentscheid zur Abwahl des Oberbürgermeisters der Stadt Frankfurt am Main, Herrn Peter Feldmann;06412000;NA;Westend-Nord;8;4;666;302;61;1029;263;62;1;262;230;32
06.11.2022;Bürgerentscheid zur Abwahl des Oberbürgermeisters der Stadt Frankfurt am Main, Herrn Peter Feldmann;06412000;NA;Westend-Süd;15;4;1065;480;78;1623;436;98;3;433;373;60
06.11.2022;Bürgerentscheid zur Abwahl des Oberbürgermeisters der Stadt Frankfurt am Main, Herrn Peter Feldmann;06412000;NA;Zeilsheim;8;4;906;330;54;1290;307;88;2;305;249;56
