datum;wahl;ags;gebiet-nr;gebiet-name;max-schnellmeldungen;anz-schnellmeldungen;A1;A2;A3;A;B;B1;C;D;D1;D2
06.11.2022;Bürgerentscheid zur Abwahl des Oberbürgermeisters der Stadt Frankfurt am Main, Herrn Peter Feldmann;06412000;01001;010-01;1;1;578;167;29;774;251;54;3;248;215;33
06.11.2022;Bürgerentscheid zur Abwahl des Oberbürgermeisters der Stadt Frankfurt am Main, Herrn Peter Feldmann;06412000;01002;010-02;1;1;554;254;47;855;212;47;2;210;177;33
06.11.2022;Bürgerentscheid zur Abwahl des Oberbürgermeisters der Stadt Frankfurt am Main, Herrn Peter Feldmann;06412000;04001;040-01;1;1;461;201;39;701;288;67;2;286;239;47
06.11.2022;Bürgerentscheid zur Abwahl des Oberbürgermeisters der Stadt Frankfurt am Main, Herrn Peter Feldmann;06412000;07001;070-01;1;1;443;199;36;678;237;67;2;235;198;37
06.11.2022;Bürgerentscheid zur Abwahl des Oberbürgermeisters der Stadt Frankfurt am Main, Herrn Peter Feldmann;06412000;08001;080-01;1;1;610;282;36;928;314;64;3;311;270;41
06.11.2022;Bürgerentscheid zur Abwahl des Oberbürgermeisters der Stadt Frankfurt am Main, Herrn Peter Feldmann;06412000;09001;090-01;1;1;807;217;54;1078;292;69;2;290;239;51
06.11.2022;Bürgerentscheid zur Abwahl des Oberbürgermeisters der Stadt Frankfurt am Main, Herrn Peter Feldmann;06412000;10001;100-01;1;1;680;283;48;1011;428;87;3;425;351;74
06.11.2022;Bürgerentscheid zur Abwahl des Oberbürgermeisters der Stadt Frankfurt am Main, Herrn Peter Feldmann;06412000;10002;100-02;1;1;509;154;36;699;182;37;1;181;149;32
06.11.2022;Bürgerentscheid zur Abwahl des Oberbürgermeisters der Stadt Frankfurt am Main, Herrn Peter Feldmann;06412000;11001;110-01;1;1;644;255;54;953;350;96;2;348;305;43
06.11.2022;Bürgerentscheid zur Abwahl des Oberbürgermeisters der Stadt Frankfurt am Main, Herrn Peter Feldmann;06412000;11002;110-02;1;1;745;261;55;1061;265;72;3;262;222;40
06.11.2022;Bürgerentscheid zur Abwahl des Oberbürgermeisters der Stadt Frankfurt am Main, Herrn Peter Feldmann;06412000;12001;120-01;1;1;678;270;50;998;313;82;3;310;268;42
06.11.2022;Bürgerentscheid zur Abwahl des Oberbürgermeisters der Stadt Frankfurt am Main, Herrn Peter Feldmann;06412000;12002;120-02;1;1;778;220;45;1043;442;118;3;439;382;57
06.11.2022;Bürgerentscheid zur Abwahl des Oberbürgermeisters der Stadt Frankfurt am Main, Herrn Peter Feldmann;06412000;12003;120-03;1;1;460;213;41;714;173;46;1;172;141;31
06.11.2022;Bürgerentscheid zur Abwahl des Oberbürgermeisters der Stadt Frankfurt am Main, Herrn Peter Feldmann;06412000;12004;120-04;1;1;459;182;31;672;263;76;2;261;214;47
06.11.2022;Bürgerentscheid zur Abwahl des Oberbürgermeisters der Stadt Frankfurt am Main, Herrn Peter Feldmann;06412000;13001;130-01;1;1;618;216;46;880;335;68;3;332;281;51
06.11.2022;Bürgerentscheid zur Abwahl des Oberbürgermeisters der Stadt Frankfurt am Main, Herrn Peter Feldmann;06412000;13002;130-02;1;1;729;230;59;1018;257;70;3;254;216;38
06.11.2022;Bürgerentscheid zur Abwahl des Oberbürgermeisters der Stadt Frankfurt am Main, Herrn Peter Feldmann;06412000;13003;130-03;1;1;498;236;30;764;336;94;3;333;283;50
06.11.2022;Bürgerentscheid zur Abwahl des Oberbürgermeisters der Stadt Frankfurt am Main, Herrn Peter Feldmann;06412000;14001;140-01;1;1;467;205;38;710;212;41;2;210;178;32
06.11.2022;Bürgerentscheid zur Abwahl des Oberbürgermeisters der Stadt Frankfurt am Main, Herrn Peter Feldmann;06412000;14002;140-02;1;1;464;197;26;687;221;52;2;219;189;30
06.11.2022;Bürgerentscheid zur Abwahl des Oberbürgermeisters der Stadt Frankfurt am Main, Herrn Peter Feldmann;06412000;14003;140-03;1;1;497;231;40;768;217;61;1;216;181;35
06.11.2022;Bürgerentscheid zur Abwahl des Oberbürgermeisters der Stadt Frankfurt am Main, Herrn Peter Feldmann;06412000;14004;140-04;1;1;538;146;40;724;290;60;2;288;243;45
06.11.2022;Bürgerentscheid zur Abwahl des Oberbürgermeisters der Stadt Frankfurt am Main, Herrn Peter Feldmann;06412000;14005;140-05;1;1;595;156;30;781;256;52;2;254;213;41
06.11.2022;Bürgerentscheid zur Abwahl des Oberbürgermeisters der Stadt Frankfurt am Main, Herrn Peter Feldmann;06412000;15101;151-01;1;1;640;246;49;935;315;95;3;312;273;39
06.11.2022;Bürgerentscheid zur Abwahl des Oberbürgermeisters der Stadt Frankfurt am Main, Herrn Peter Feldmann;06412000;15102;151-02;1;1;584;268;45;897;319;84;3;316;279;37
06.11.2022;Bürgerentscheid zur Abwahl des Oberbürgermeisters der Stadt Frankfurt am Main, Herrn Peter Feldmann;06412000;15103;151-03;1;1;460;211;39;710;245;55;2;243;204;39
06.11.2022;Bürgerentscheid zur Abwahl des Oberbürgermeisters der Stadt Frankfurt am Main, Herrn Peter Feldmann;06412000;15104;151-04;1;1;524;149;31;704;187;58;2;185;161;24
06.11.2022;Bürgerentscheid zur Abwahl des Oberbürgermeisters der Stadt Frankfurt am Main, Herrn Peter Feldmann;06412000;15301;153-01;1;1;609;259;45;913;380;81;3;377;323;54
06.11.2022;Bürgerentscheid zur Abwahl des Oberbürgermeisters der Stadt Frankfurt am Main, Herrn Peter Feldmann;06412000;15302;153-02;1;1;644;248;50;942;296;80;3;293;255;38
06.11.2022;Bürgerentscheid zur Abwahl des Oberbürgermeisters der Stadt Frankfurt am Main, Herrn Peter Feldmann;06412000;15401;154-01;1;1;457;202;28;687;269;70;2;267;232;35
06.11.2022;Bürgerentscheid zur Abwahl des Oberbürgermeisters der Stadt Frankfurt am Main, Herrn Peter Feldmann;06412000;15402;154-02;1;1;610;179;35;824;241;53;2;239;207;32
06.11.2022;Bürgerentscheid zur Abwahl des Oberbürgermeisters der Stadt Frankfurt am Main, Herrn Peter Feldmann;06412000;16101;161-01;1;1;624;296;41;961;260;71;2;258;227;31
06.11.2022;Bürgerentscheid zur Abwahl des Oberbürgermeisters der Stadt Frankfurt am Main, Herrn Peter Feldmann;06412000;16102;161-02;1;1;656;254;42;952;349;96;3;346;308;38
06.11.2022;Bürgerentscheid zur Abwahl des Oberbürgermeisters der Stadt Frankfurt am Main, Herrn Peter Feldmann;06412000;16103;161-03;1;1;516;163;30;709;231;43;2;229;190;39
06.11.2022;Bürgerentscheid zur Abwahl des Oberbürgermeisters der Stadt Frankfurt am Main, Herrn Peter Feldmann;06412000;16104;161-04;1;1;545;168;35;748;186;36;2;184;152;32
06.11.2022;Bürgerentscheid zur Abwahl des Oberbürgermeisters der Stadt Frankfurt am Main, Herrn Peter Feldmann;06412000;16201;162-01;1;1;569;152;44;765;217;63;1;216;189;27
06.11.2022;Bürgerentscheid zur Abwahl des Oberbürgermeisters der Stadt Frankfurt am Main, Herrn Peter Feldmann;06412000;16202;162-02;1;1;614;281;38;933;237;49;2;235;196;39
06.11.2022;Bürgerentscheid zur Abwahl des Oberbürgermeisters der Stadt Frankfurt am Main, Herrn Peter Feldmann;06412000;16203;162-03;1;1;547;172;38;757;244;52;2;242;199;43
06.11.2022;Bürgerentscheid zur Abwahl des Oberbürgermeisters der Stadt Frankfurt am Main, Herrn Peter Feldmann;06412000;16204;162-04;1;1;542;197;41;780;284;58;2;282;231;51
06.11.2022;Bürgerentscheid zur Abwahl des Oberbürgermeisters der Stadt Frankfurt am Main, Herrn Peter Feldmann;06412000;16205;162-05;1;1;747;215;40;1002;332;81;3;329;285;44
06.11.2022;Bürgerentscheid zur Abwahl des Oberbürgermeisters der Stadt Frankfurt am Main, Herrn Peter Feldmann;06412000;16301;163-01;1;1;688;176;56;920;332;68;2;330;275;55
06.11.2022;Bürgerentscheid zur Abwahl des Oberbürgermeisters der Stadt Frankfurt am Main, Herrn Peter Feldmann;06412000;16302;163-02;1;1;481;218;43;742;281;59;2;279;242;37
06.11.2022;Bürgerentscheid zur Abwahl des Oberbürgermeisters der Stadt Frankfurt am Main, Herrn Peter Feldmann;06412000;16303;163-03;1;1;605;189;37;831;193;45;1;192;161;31
06.11.2022;Bürgerentscheid zur Abwahl des Oberbürgermeisters der Stadt Frankfurt am Main, Herrn Peter Feldmann;06412000;16401;164-01;1;1;698;285;41;1024;241;62;2;239;200;39
06.11.2022;Bürgerentscheid zur Abwahl des Oberbürgermeisters der Stadt Frankfurt am Main, Herrn Peter Feldmann;06412000;16501;165-01;1;1;606;238;45;889;326;70;2;324;271;53
06.11.2022;Bürgerentscheid zur Abwahl des Oberbürgermeisters der Stadt Frankfurt am Main, Herrn Peter Feldmann;06412000;16502;165-02;1;1;439;207;38;684;211;41;2;209;181;28
06.11.2022;Bürgerentscheid zur Abwahl des Oberbürgermeisters der Stadt Frankfurt am Main, Herrn Peter Feldmann;06412000;16503;165-03;1;1;531;202;40;773;226;53;2;224;195;29
06.11.2022;Bürgerentscheid zur Abwahl des Oberbürgermeisters der Stadt Frankfurt am Main, Herrn Peter Feldmann;06412000;16504;165-04;1;1;544;194;45;783;326;74;2;324;270;54
06.11.2022;Bürgerentscheid zur Abwahl des Oberbürgermeisters der Stadt Frankfurt am Main, Herrn Peter Feldmann;06412000;17001;170-01;1;1;576;193;50;819;238;44;2;236;198;38
06.11.2022;Bürgerentscheid zur Abwahl des Oberbürgermeisters der Stadt Frankfurt am Main, Herrn Peter Feldmann;06412000;17002;170-02;1;1;595;175;50;820;290;63;3;287;244;43
06.11.2022;Bürgerentscheid zur Abwahl des Oberbürgermeisters der Stadt Frankfurt am Main, Herrn Peter Feldmann;06412000;17003;170-03;1;1;473;165;35;673;152;28;1;151;133;18
06.11.2022;Bürgerentscheid zur Abwahl des Oberbürgermeisters der Stadt Frankfurt am Main, Herrn Peter Feldmann;06412000;18001;180-01;1;1;583;239;38;860;256;71;2;254;218;36
06.11.2022;Bürgerentscheid zur Abwahl des Oberbürgermeisters der Stadt Frankfurt am Main, Herrn Peter Feldmann;06412000;18002;180-02;1;1;779;215;44;1038;303;63;2;301;253;48
06.11.2022;Bürgerentscheid zur Abwahl des Oberbürgermeisters der Stadt Frankfurt am Main, Herrn Peter Feldmann;06412000;18003;180-03;1;1;571;261;50;882;269;57;2;267;227;40
06.11.2022;Bürgerentscheid zur Abwahl des Oberbürgermeisters der Stadt Frankfurt am Main, Herrn Peter Feldmann;06412000;19101;191-01;1;1;649;189;43;881;367;72;4;363;296;67
06.11.2022;Bürgerentscheid zur Abwahl des Oberbürgermeisters der Stadt Frankfurt am Main, Herrn Peter Feldmann;06412000;19102;191-02;1;1;541;224;31;796;324;95;2;322;269;53
06.11.2022;Bürgerentscheid zur Abwahl des Oberbürgermeisters der Stadt Frankfurt am Main, Herrn Peter Feldmann;06412000;19103;191-03;1;1;824;219;41;1084;324;84;3;321;284;37
06.11.2022;Bürgerentscheid zur Abwahl des Oberbürgermeisters der Stadt Frankfurt am Main, Herrn Peter Feldmann;06412000;19201;192-01;1;1;650;235;39;924;391;74;4;387;320;67
06.11.2022;Bürgerentscheid zur Abwahl des Oberbürgermeisters der Stadt Frankfurt am Main, Herrn Peter Feldmann;06412000;19202;192-02;1;1;797;219;51;1067;244;53;2;242;203;39
06.11.2022;Bürgerentscheid zur Abwahl des Oberbürgermeisters der Stadt Frankfurt am Main, Herrn Peter Feldmann;06412000;20101;201-01;1;1;558;250;37;845;261;56;2;259;225;34
06.11.2022;Bürgerentscheid zur Abwahl des Oberbürgermeisters der Stadt Frankfurt am Main, Herrn Peter Feldmann;06412000;20102;201-02;1;1;751;285;59;1095;330;63;2;328;283;45
06.11.2022;Bürgerentscheid zur Abwahl des Oberbürgermeisters der Stadt Frankfurt am Main, Herrn Peter Feldmann;06412000;20201;202-01;1;1;728;294;57;1079;272;57;3;269;225;44
06.11.2022;Bürgerentscheid zur Abwahl des Oberbürgermeisters der Stadt Frankfurt am Main, Herrn Peter Feldmann;06412000;20202;202-02;1;1;472;164;34;670;257;64;2;255;209;46
06.11.2022;Bürgerentscheid zur Abwahl des Oberbürgermeisters der Stadt Frankfurt am Main, Herrn Peter Feldmann;06412000;20301;203-01;1;1;466;222;45;733;274;53;2;272;235;37
06.11.2022;Bürgerentscheid zur Abwahl des Oberbürgermeisters der Stadt Frankfurt am Main, Herrn Peter Feldmann;06412000;20302;203-02;1;1;638;252;44;934;288;87;2;286;250;36
06.11.2022;Bürgerentscheid zur Abwahl des Oberbürgermeisters der Stadt Frankfurt am Main, Herrn Peter Feldmann;06412000;20303;203-03;1;1;506;138;28;672;236;60;2;234;193;41
06.11.2022;Bürgerentscheid zur Abwahl des Oberbürgermeisters der Stadt Frankfurt am Main, Herrn Peter Feldmann;06412000;20304;203-04;1;1;546;237;31;814;281;73;2;279;243;36
06.11.2022;Bürgerentscheid zur Abwahl des Oberbürgermeisters der Stadt Frankfurt am Main, Herrn Peter Feldmann;06412000;21101;211-01;1;1;491;158;37;686;189;58;2;187;153;34
06.11.2022;Bürgerentscheid zur Abwahl des Oberbürgermeisters der Stadt Frankfurt am Main, Herrn Peter Feldmann;06412000;21102;211-02;1;1;523;230;46;799;292;86;2;290;243;47
06.11.2022;Bürgerentscheid zur Abwahl des Oberbürgermeisters der Stadt Frankfurt am Main, Herrn Peter Feldmann;06412000;21103;211-03;1;1;607;220;38;865;202;49;1;201;172;29
06.11.2022;Bürgerentscheid zur Abwahl des Oberbürgermeisters der Stadt Frankfurt am Main, Herrn Peter Feldmann;06412000;21201;212-01;1;1;726;192;39;957;366;107;3;363;313;50
06.11.2022;Bürgerentscheid zur Abwahl des Oberbürgermeisters der Stadt Frankfurt am Main, Herrn Peter Feldmann;06412000;21202;212-02;1;1;619;265;54;938;361;100;4;357;309;48
06.11.2022;Bürgerentscheid zur Abwahl des Oberbürgermeisters der Stadt Frankfurt am Main, Herrn Peter Feldmann;06412000;21203;212-03;1;1;475;223;30;728;259;70;2;257;217;40
06.11.2022;Bürgerentscheid zur Abwahl des Oberbürgermeisters der Stadt Frankfurt am Main, Herrn Peter Feldmann;06412000;21301;213-01;1;1;802;206;59;1067;337;72;3;334;279;55
06.11.2022;Bürgerentscheid zur Abwahl des Oberbürgermeisters der Stadt Frankfurt am Main, Herrn Peter Feldmann;06412000;22101;221-01;1;1;500;198;34;732;197;48;1;196;164;32
06.11.2022;Bürgerentscheid zur Abwahl des Oberbürgermeisters der Stadt Frankfurt am Main, Herrn Peter Feldmann;06412000;22102;221-02;1;1;572;273;38;883;204;61;1;203;181;22
06.11.2022;Bürgerentscheid zur Abwahl des Oberbürgermeisters der Stadt Frankfurt am Main, Herrn Peter Feldmann;06412000;22103;221-03;1;1;596;229;34;859;276;69;3;273;227;46
06.11.2022;Bürgerentscheid zur Abwahl des Oberbürgermeisters der Stadt Frankfurt am Main, Herrn Peter Feldmann;06412000;22201;222-01;1;1;446;197;39;682;251;53;2;249;216;33
06.11.2022;Bürgerentscheid zur Abwahl des Oberbürgermeisters der Stadt Frankfurt am Main, Herrn Peter Feldmann;06412000;22202;222-02;1;1;606;194;51;851;335;85;2;333;287;46
06.11.2022;Bürgerentscheid zur Abwahl des Oberbürgermeisters der Stadt Frankfurt am Main, Herrn Peter Feldmann;06412000;22203;222-03;1;1;598;279;39;916;263;76;2;261;227;34
06.11.2022;Bürgerentscheid zur Abwahl des Oberbürgermeisters der Stadt Frankfurt am Main, Herrn Peter Feldmann;06412000;22204;222-04;1;1;618;293;43;954;291;61;3;288;243;45
06.11.2022;Bürgerentscheid zur Abwahl des Oberbürgermeisters der Stadt Frankfurt am Main, Herrn Peter Feldmann;06412000;23001;230-01;1;1;709;306;49;1064;329;65;3;326;279;47
06.11.2022;Bürgerentscheid zur Abwahl des Oberbürgermeisters der Stadt Frankfurt am Main, Herrn Peter Feldmann;06412000;23002;230-02;1;1;698;186;35;919;276;79;3;273;232;41
06.11.2022;Bürgerentscheid zur Abwahl des Oberbürgermeisters der Stadt Frankfurt am Main, Herrn Peter Feldmann;06412000;23003;230-03;1;1;693;186;46;925;253;73;2;251;218;33
06.11.2022;Bürgerentscheid zur Abwahl des Oberbürgermeisters der Stadt Frankfurt am Main, Herrn Peter Feldmann;06412000;24001;240-01;1;1;553;234;46;833;275;51;2;273;239;34
06.11.2022;Bürgerentscheid zur Abwahl des Oberbürgermeisters der Stadt Frankfurt am Main, Herrn Peter Feldmann;06412000;24002;240-02;1;1;645;266;50;961;304;79;2;302;255;47
06.11.2022;Bürgerentscheid zur Abwahl des Oberbürgermeisters der Stadt Frankfurt am Main, Herrn Peter Feldmann;06412000;25101;251-01;1;1;548;253;42;843;332;88;4;328;287;41
06.11.2022;Bürgerentscheid zur Abwahl des Oberbürgermeisters der Stadt Frankfurt am Main, Herrn Peter Feldmann;06412000;25102;251-02;1;1;537;180;30;747;274;56;2;272;222;50
06.11.2022;Bürgerentscheid zur Abwahl des Oberbürgermeisters der Stadt Frankfurt am Main, Herrn Peter Feldmann;06412000;25103;251-03;1;1;567;156;36;759;304;81;3;301;247;54
06.11.2022;Bürgerentscheid zur Abwahl des Oberbürgermeisters der Stadt Frankfurt am Main, Herrn Peter Feldmann;06412000;25104;251-04;1;1;606;285;54;945;276;76;3;273;240;33
06.11.2022;Bürgerentscheid zur Abwahl des Oberbürgermeisters der Stadt Frankfurt am Main, Herrn Peter Feldmann;06412000;25201;252-01;1;1;658;302;47;1007;298;78;2;296;253;43
06.11.2022;Bürgerentscheid zur Abwahl des Oberbürgermeisters der Stadt Frankfurt am Main, Herrn Peter Feldmann;06412000;25202;252-02;1;1;585;224;43;852;228;65;1;227;197;30
06.11.2022;Bürgerentscheid zur Abwahl des Oberbürgermeisters der Stadt Frankfurt am Main, Herrn Peter Feldmann;06412000;25203;252-03;1;1;572;160;47;779;195;53;1;194;164;30
06.11.2022;Bürgerentscheid zur Abwahl des Oberbürgermeisters der Stadt Frankfurt am Main, Herrn Peter Feldmann;06412000;25204;252-04;1;1;497;162;41;700;183;52;1;182;159;23
06.11.2022;Bürgerentscheid zur Abwahl des Oberbürgermeisters der Stadt Frankfurt am Main, Herrn Peter Feldmann;06412000;25205;252-05;1;1;633;247;53;933;392;108;3;389;317;72
06.11.2022;Bürgerentscheid zur Abwahl des Oberbürgermeisters der Stadt Frankfurt am Main, Herrn Peter Feldmann;06412000;26101;261-01;1;1;611;257;43;911;376;109;4;372;330;42
06.11.2022;Bürgerentscheid zur Abwahl des Oberbürgermeisters der Stadt Frankfurt am Main, Herrn Peter Feldmann;06412000;26102;261-02;1;1;507;161;41;709;230;48;1;229;191;38
06.11.2022;Bürgerentscheid zur Abwahl des Oberbürgermeisters der Stadt Frankfurt am Main, Herrn Peter Feldmann;06412000;26103;261-03;1;1;573;218;37;828;242;73;2;240;196;44
06.11.2022;Bürgerentscheid zur Abwahl des Oberbürgermeisters der Stadt Frankfurt am Main, Herrn Peter Feldmann;06412000;26201;262-01;1;1;467;177;36;680;262;49;2;260;216;44
06.11.2022;Bürgerentscheid zur Abwahl des Oberbürgermeisters der Stadt Frankfurt am Main, Herrn Peter Feldmann;06412000;26202;262-02;1;1;624;241;42;907;315;85;3;312;255;57
06.11.2022;Bürgerentscheid zur Abwahl des Oberbürgermeisters der Stadt Frankfurt am Main, Herrn Peter Feldmann;06412000;27101;271-01;1;1;578;153;44;775;307;70;2;305;254;51
06.11.2022;Bürgerentscheid zur Abwahl des Oberbürgermeisters der Stadt Frankfurt am Main, Herrn Peter Feldmann;06412000;27102;271-02;1;1;768;276;58;1102;351;86;3;348;308;40
06.11.2022;Bürgerentscheid zur Abwahl des Oberbürgermeisters der Stadt Frankfurt am Main, Herrn Peter Feldmann;06412000;27201;272-01;1;1;456;188;26;670;208;63;1;207;172;35
06.11.2022;Bürgerentscheid zur Abwahl des Oberbürgermeisters der Stadt Frankfurt am Main, Herrn Peter Feldmann;06412000;27202;272-02;1;1;492;220;27;739;245;48;2;243;202;41
06.11.2022;Bürgerentscheid zur Abwahl des Oberbürgermeisters der Stadt Frankfurt am Main, Herrn Peter Feldmann;06412000;27203;272-03;1;1;608;171;43;822;249;67;2;247;214;33
06.11.2022;Bürgerentscheid zur Abwahl des Oberbürgermeisters der Stadt Frankfurt am Main, Herrn Peter Feldmann;06412000;27204;272-04;1;1;571;204;32;807;260;50;2;258;223;35
06.11.2022;Bürgerentscheid zur Abwahl des Oberbürgermeisters der Stadt Frankfurt am Main, Herrn Peter Feldmann;06412000;27205;272-05;1;1;698;240;46;984;298;86;3;295;247;48
06.11.2022;Bürgerentscheid zur Abwahl des Oberbürgermeisters der Stadt Frankfurt am Main, Herrn Peter Feldmann;06412000;28101;281-01;1;1;725;206;41;972;365;89;2;363;308;55
06.11.2022;Bürgerentscheid zur Abwahl des Oberbürgermeisters der Stadt Frankfurt am Main, Herrn Peter Feldmann;06412000;28102;281-02;1;1;530;214;45;789;271;81;3;268;229;39
06.11.2022;Bürgerentscheid zur Abwahl des Oberbürgermeisters der Stadt Frankfurt am Main, Herrn Peter Feldmann;06412000;28103;281-03;1;1;590;260;45;895;261;53;1;260;222;38
06.11.2022;Bürgerentscheid zur Abwahl des Oberbürgermeisters der Stadt Frankfurt am Main, Herrn Peter Feldmann;06412000;28201;282-01;1;1;625;183;46;854;300;77;2;298;263;35
06.11.2022;Bürgerentscheid zur Abwahl des Oberbürgermeisters der Stadt Frankfurt am Main, Herrn Peter Feldmann;06412000;28202;282-02;1;1;461;211;40;712;281;86;2;279;228;51
06.11.2022;Bürgerentscheid zur Abwahl des Oberbürgermeisters der Stadt Frankfurt am Main, Herrn Peter Feldmann;06412000;28203;282-03;1;1;682;246;52;980;284;55;2;282;245;37
06.11.2022;Bürgerentscheid zur Abwahl des Oberbürgermeisters der Stadt Frankfurt am Main, Herrn Peter Feldmann;06412000;29001;290-01;1;1;756;205;38;999;278;81;2;276;230;46
06.11.2022;Bürgerentscheid zur Abwahl des Oberbürgermeisters der Stadt Frankfurt am Main, Herrn Peter Feldmann;06412000;29002;290-02;1;1;605;175;35;815;324;70;2;322;277;45
06.11.2022;Bürgerentscheid zur Abwahl des Oberbürgermeisters der Stadt Frankfurt am Main, Herrn Peter Feldmann;06412000;30001;300-01;1;1;485;150;32;667;200;37;1;199;177;22
06.11.2022;Bürgerentscheid zur Abwahl des Oberbürgermeisters der Stadt Frankfurt am Main, Herrn Peter Feldmann;06412000;30002;300-02;1;1;449;182;34;665;199;46;1;198;172;26
06.11.2022;Bürgerentscheid zur Abwahl des Oberbürgermeisters der Stadt Frankfurt am Main, Herrn Peter Feldmann;06412000;32101;321-01;1;1;588;143;35;766;204;42;1;203;174;29
06.11.2022;Bürgerentscheid zur Abwahl des Oberbürgermeisters der Stadt Frankfurt am Main, Herrn Peter Feldmann;06412000;32102;321-02;1;1;699;252;44;995;336;65;2;334;297;37
06.11.2022;Bürgerentscheid zur Abwahl des Oberbürgermeisters der Stadt Frankfurt am Main, Herrn Peter Feldmann;06412000;32103;321-03;1;1;552;140;40;732;188;54;1;187;158;29
06.11.2022;Bürgerentscheid zur Abwahl des Oberbürgermeisters der Stadt Frankfurt am Main, Herrn Peter Feldmann;06412000;32201;322-01;1;1;614;166;36;816;256;79;2;254;226;28
06.11.2022;Bürgerentscheid zur Abwahl des Oberbürgermeisters der Stadt Frankfurt am Main, Herrn Peter Feldmann;06412000;32202;322-02;1;1;543;182;28;753;319;88;2;317;280;37
06.11.2022;Bürgerentscheid zur Abwahl des Oberbürgermeisters der Stadt Frankfurt am Main, Herrn Peter Feldmann;06412000;32203;322-03;1;1;770;240;51;1061;400;90;3;397;350;47
06.11.2022;Bürgerentscheid zur Abwahl des Oberbürgermeisters der Stadt Frankfurt am Main, Herrn Peter Feldmann;06412000;32204;322-04;1;1;657;250;36;943;337;86;3;334;291;43
06.11.2022;Bürgerentscheid zur Abwahl des Oberbürgermeisters der Stadt Frankfurt am Main, Herrn Peter Feldmann;06412000;32205;322-05;1;1;624;170;46;840;232;57;2;230;195;35
06.11.2022;Bürgerentscheid zur Abwahl des Oberbürgermeisters der Stadt Frankfurt am Main, Herrn Peter Feldmann;06412000;32301;323-01;1;1;516;150;42;708;233;60;2;231;191;40
06.11.2022;Bürgerentscheid zur Abwahl des Oberbürgermeisters der Stadt Frankfurt am Main, Herrn Peter Feldmann;06412000;32302;323-02;1;1;631;232;36;899;256;63;2;254;225;29
06.11.2022;Bürgerentscheid zur Abwahl des Oberbürgermeisters der Stadt Frankfurt am Main, Herrn Peter Feldmann;06412000;32303;323-03;1;1;749;208;53;1010;270;62;2;268;229;39
06.11.2022;Bürgerentscheid zur Abwahl des Oberbürgermeisters der Stadt Frankfurt am Main, Herrn Peter Feldmann;06412000;32304;323-04;1;1;653;219;35;907;240;70;1;239;197;42
06.11.2022;Bürgerentscheid zur Abwahl des Oberbürgermeisters der Stadt Frankfurt am Main, Herrn Peter Feldmann;06412000;32305;323-05;1;1;626;215;55;896;255;53;2;253;213;40
06.11.2022;Bürgerentscheid zur Abwahl des Oberbürgermeisters der Stadt Frankfurt am Main, Herrn Peter Feldmann;06412000;32306;323-06;1;1;642;190;42;874;273;74;3;270;231;39
06.11.2022;Bürgerentscheid zur Abwahl des Oberbürgermeisters der Stadt Frankfurt am Main, Herrn Peter Feldmann;06412000;32401;324-01;1;1;545;207;44;796;249;70;2;247;219;28
06.11.2022;Bürgerentscheid zur Abwahl des Oberbürgermeisters der Stadt Frankfurt am Main, Herrn Peter Feldmann;06412000;32402;324-02;1;1;559;198;35;792;252;77;2;250;204;46
06.11.2022;Bürgerentscheid zur Abwahl des Oberbürgermeisters der Stadt Frankfurt am Main, Herrn Peter Feldmann;06412000;32403;324-03;1;1;675;177;48;900;291;89;3;288;241;47
06.11.2022;Bürgerentscheid zur Abwahl des Oberbürgermeisters der Stadt Frankfurt am Main, Herrn Peter Feldmann;06412000;32404;324-04;1;1;585;191;32;808;208;64;1;207;170;37
06.11.2022;Bürgerentscheid zur Abwahl des Oberbürgermeisters der Stadt Frankfurt am Main, Herrn Peter Feldmann;06412000;32601;326-01;1;1;692;276;62;1030;322;91;3;319;264;55
06.11.2022;Bürgerentscheid zur Abwahl des Oberbürgermeisters der Stadt Frankfurt am Main, Herrn Peter Feldmann;06412000;32602;326-02;1;1;732;207;45;984;300;81;3;297;245;52
06.11.2022;Bürgerentscheid zur Abwahl des Oberbürgermeisters der Stadt Frankfurt am Main, Herrn Peter Feldmann;06412000;32603;326-03;1;1;477;187;38;702;216;41;2;214;187;27
06.11.2022;Bürgerentscheid zur Abwahl des Oberbürgermeisters der Stadt Frankfurt am Main, Herrn Peter Feldmann;06412000;33101;331-01;1;1;547;233;45;825;289;80;3;286;252;34
06.11.2022;Bürgerentscheid zur Abwahl des Oberbürgermeisters der Stadt Frankfurt am Main, Herrn Peter Feldmann;06412000;33102;331-02;1;1;692;278;51;1021;418;92;5;413;366;47
06.11.2022;Bürgerentscheid zur Abwahl des Oberbürgermeisters der Stadt Frankfurt am Main, Herrn Peter Feldmann;06412000;33103;331-03;1;1;618;253;39;910;292;57;2;290;240;50
06.11.2022;Bürgerentscheid zur Abwahl des Oberbürgermeisters der Stadt Frankfurt am Main, Herrn Peter Feldmann;06412000;33201;332-01;1;1;730;236;51;1017;365;113;3;362;319;43
06.11.2022;Bürgerentscheid zur Abwahl des Oberbürgermeisters der Stadt Frankfurt am Main, Herrn Peter Feldmann;06412000;33202;332-02;1;1;738;183;36;957;326;101;3;323;267;56
06.11.2022;Bürgerentscheid zur Abwahl des Oberbürgermeisters der Stadt Frankfurt am Main, Herrn Peter Feldmann;06412000;33203;332-03;1;1;614;285;42;941;236;58;2;234;196;38
06.11.2022;Bürgerentscheid zur Abwahl des Oberbürgermeisters der Stadt Frankfurt am Main, Herrn Peter Feldmann;06412000;33204;332-04;1;1;679;194;36;909;243;72;3;240;201;39
06.11.2022;Bürgerentscheid zur Abwahl des Oberbürgermeisters der Stadt Frankfurt am Main, Herrn Peter Feldmann;06412000;33205;332-05;1;1;695;232;37;964;368;109;2;366;299;67
06.11.2022;Bürgerentscheid zur Abwahl des Oberbürgermeisters der Stadt Frankfurt am Main, Herrn Peter Feldmann;06412000;33206;332-06;1;1;514;245;49;808;255;51;2;253;209;44
06.11.2022;Bürgerentscheid zur Abwahl des Oberbürgermeisters der Stadt Frankfurt am Main, Herrn Peter Feldmann;06412000;34101;341-01;1;1;650;222;37;909;351;69;4;347;282;65
06.11.2022;Bürgerentscheid zur Abwahl des Oberbürgermeisters der Stadt Frankfurt am Main, Herrn Peter Feldmann;06412000;34102;341-02;1;1;694;213;55;962;356;108;4;352;305;47
06.11.2022;Bürgerentscheid zur Abwahl des Oberbürgermeisters der Stadt Frankfurt am Main, Herrn Peter Feldmann;06412000;34103;341-03;1;1;468;185;31;684;183;36;2;181;151;30
06.11.2022;Bürgerentscheid zur Abwahl des Oberbürgermeisters der Stadt Frankfurt am Main, Herrn Peter Feldmann;06412000;34201;342-01;1;1;514;131;31;676;258;78;3;255;208;47
06.11.2022;Bürgerentscheid zur Abwahl des Oberbürgermeisters der Stadt Frankfurt am Main, Herrn Peter Feldmann;06412000;34202;342-02;1;1;706;251;55;1012;350;65;3;347;286;61
06.11.2022;Bürgerentscheid zur Abwahl des Oberbürgermeisters der Stadt Frankfurt am Main, Herrn Peter Feldmann;06412000;34301;343-01;1;1;521;244;36;801;229;63;1;228;192;36
06.11.2022;Bürgerentscheid zur Abwahl des Oberbürgermeisters der Stadt Frankfurt am Main, Herrn Peter Feldmann;06412000;34401;344-01;1;1;478;220;39;737;182;40;2;180;156;24
06.11.2022;Bürgerentscheid zur Abwahl des Oberbürgermeisters der Stadt Frankfurt am Main, Herrn Peter Feldmann;06412000;35001;350-01;1;1;750;239;52;1041;363;80;3;360;302;58
06.11.2022;Bürgerentscheid zur Abwahl des Oberbürgermeisters der Stadt Frankfurt am Main, Herrn Peter Feldmann;06412000;35002;350-02;1;1;541;228;51;820;197;60;1;196;164;32
06.11.2022;Bürgerentscheid zur Abwahl des Oberbürgermeisters der Stadt Frankfurt am Main, Herrn Peter Feldmann;06412000;35003;350-03;1;1;690;317;48;1055;257;60;2;255;225;30
06.11.2022;Bürgerentscheid zur Abwahl des Oberbürgermeisters der Stadt Frankfurt am Main, Herrn Peter Feldmann;06412000;35004;350-04;1;1;690;301;48;1039;282;83;2;280;234;46
06.11.2022;Bürgerentscheid zur Abwahl des Oberbürgermeisters der Stadt Frankfurt am Main, Herrn Peter Feldmann;06412000;36101;361-01;1;1;772;245;47;1064;354;69;3;351;304;47
06.11.2022;Bürgerentscheid zur Abwahl des Oberbürgermeisters der Stadt Frankfurt am Main, Herrn Peter Feldmann;06412000;36102;361-02;1;1;733;265;39;1037;263;57;2;261;218;43
06.11.2022;Bürgerentscheid zur Abwahl des Oberbürgermeisters der Stadt Frankfurt am Main, Herrn Peter Feldmann;06412000;36103;361-03;1;1;708;227;57;992;396;89;4;392;343;49
06.11.2022;Bürgerentscheid zur Abwahl des Oberbürgermeisters der Stadt Frankfurt am Main, Herrn Peter Feldmann;06412000;36201;362-01;1;1;550;240;32;822;335;69;2;333;280;53
06.11.2022;Bürgerentscheid zur Abwahl des Oberbürgermeisters der Stadt Frankfurt am Main, Herrn Peter Feldmann;06412000;36202;362-02;1;1;788;223;45;1056;401;85;4;397;324;73
06.11.2022;Bürgerentscheid zur Abwahl des Oberbürgermeisters der Stadt Frankfurt am Main, Herrn Peter Feldmann;06412000;36203;362-03;1;1;680;167;34;881;252;77;2;250;215;35
06.11.2022;Bürgerentscheid zur Abwahl des Oberbürgermeisters der Stadt Frankfurt am Main, Herrn Peter Feldmann;06412000;36204;362-04;1;1;604;221;35;860;273;75;2;271;237;34
06.11.2022;Bürgerentscheid zur Abwahl des Oberbürgermeisters der Stadt Frankfurt am Main, Herrn Peter Feldmann;06412000;37101;371-01;1;1;554;163;29;746;281;55;2;279;238;41
06.11.2022;Bürgerentscheid zur Abwahl des Oberbürgermeisters der Stadt Frankfurt am Main, Herrn Peter Feldmann;06412000;37102;371-02;1;1;525;240;41;806;269;72;2;267;219;48
06.11.2022;Bürgerentscheid zur Abwahl des Oberbürgermeisters der Stadt Frankfurt am Main, Herrn Peter Feldmann;06412000;37103;371-03;1;1;478;172;31;681;252;77;2;250;220;30
06.11.2022;Bürgerentscheid zur Abwahl des Oberbürgermeisters der Stadt Frankfurt am Main, Herrn Peter Feldmann;06412000;37104;371-04;1;1;480;218;46;744;182;35;1;181;157;24
06.11.2022;Bürgerentscheid zur Abwahl des Oberbürgermeisters der Stadt Frankfurt am Main, Herrn Peter Feldmann;06412000;37105;371-05;1;1;559;224;30;813;247;66;2;245;213;32
06.11.2022;Bürgerentscheid zur Abwahl des Oberbürgermeisters der Stadt Frankfurt am Main, Herrn Peter Feldmann;06412000;37106;371-06;1;1;521;157;32;710;202;52;2;200;169;31
06.11.2022;Bürgerentscheid zur Abwahl des Oberbürgermeisters der Stadt Frankfurt am Main, Herrn Peter Feldmann;06412000;37201;372-01;1;1;770;235;44;1049;377;77;4;373;318;55
06.11.2022;Bürgerentscheid zur Abwahl des Oberbürgermeisters der Stadt Frankfurt am Main, Herrn Peter Feldmann;06412000;37202;372-02;1;1;450;186;30;666;225;56;1;224;191;33
06.11.2022;Bürgerentscheid zur Abwahl des Oberbürgermeisters der Stadt Frankfurt am Main, Herrn Peter Feldmann;06412000;37203;372-03;1;1;691;289;55;1035;297;85;3;294;249;45
06.11.2022;Bürgerentscheid zur Abwahl des Oberbürgermeisters der Stadt Frankfurt am Main, Herrn Peter Feldmann;06412000;37204;372-04;1;1;667;216;48;931;363;89;3;360;307;53
06.11.2022;Bürgerentscheid zur Abwahl des Oberbürgermeisters der Stadt Frankfurt am Main, Herrn Peter Feldmann;06412000;37205;372-05;1;1;576;271;39;886;271;60;3;268;236;32
06.11.2022;Bürgerentscheid zur Abwahl des Oberbürgermeisters der Stadt Frankfurt am Main, Herrn Peter Feldmann;06412000;37206;372-06;1;1;463;217;31;711;278;60;2;276;245;31
06.11.2022;Bürgerentscheid zur Abwahl des Oberbürgermeisters der Stadt Frankfurt am Main, Herrn Peter Feldmann;06412000;38001;380-01;1;1;669;301;41;1011;359;76;3;356;299;57
06.11.2022;Bürgerentscheid zur Abwahl des Oberbürgermeisters der Stadt Frankfurt am Main, Herrn Peter Feldmann;06412000;38002;380-02;1;1;507;180;32;719;174;39;2;172;146;26
06.11.2022;Bürgerentscheid zur Abwahl des Oberbürgermeisters der Stadt Frankfurt am Main, Herrn Peter Feldmann;06412000;38003;380-03;1;1;448;208;27;683;239;49;2;237;195;42
06.11.2022;Bürgerentscheid zur Abwahl des Oberbürgermeisters der Stadt Frankfurt am Main, Herrn Peter Feldmann;06412000;38004;380-04;1;1;614;226;42;882;298;84;2;296;263;33
06.11.2022;Bürgerentscheid zur Abwahl des Oberbürgermeisters der Stadt Frankfurt am Main, Herrn Peter Feldmann;06412000;38005;380-05;1;1;708;249;61;1018;345;66;3;342;284;58
06.11.2022;Bürgerentscheid zur Abwahl des Oberbürgermeisters der Stadt Frankfurt am Main, Herrn Peter Feldmann;06412000;38006;380-06;1;1;718;285;50;1053;308;84;3;305;258;47
06.11.2022;Bürgerentscheid zur Abwahl des Oberbürgermeisters der Stadt Frankfurt am Main, Herrn Peter Feldmann;06412000;39001;390-01;1;1;541;182;40;763;275;77;2;273;226;47
06.11.2022;Bürgerentscheid zur Abwahl des Oberbürgermeisters der Stadt Frankfurt am Main, Herrn Peter Feldmann;06412000;39002;390-02;1;1;532;172;46;750;245;70;1;244;211;33
06.11.2022;Bürgerentscheid zur Abwahl des Oberbürgermeisters der Stadt Frankfurt am Main, Herrn Peter Feldmann;06412000;39003;390-03;1;1;755;217;60;1032;331;92;2;329;278;51
06.11.2022;Bürgerentscheid zur Abwahl des Oberbürgermeisters der Stadt Frankfurt am Main, Herrn Peter Feldmann;06412000;39004;390-04;1;1;718;233;45;996;421;116;3;418;344;74
06.11.2022;Bürgerentscheid zur Abwahl des Oberbürgermeisters der Stadt Frankfurt am Main, Herrn Peter Feldmann;06412000;39005;390-05;1;1;591;183;47;821;234;55;2;232;203;29
06.11.2022;Bürgerentscheid zur Abwahl des Oberbürgermeisters der Stadt Frankfurt am Main, Herrn Peter Feldmann;06412000;39006;390-06;1;1;519;157;36;712;202;42;1;201;176;25
06.11.2022;Bürgerentscheid zur Abwahl des Oberbürgermeisters der Stadt Frankfurt am Main, Herrn Peter Feldmann;06412000;39007;390-07;1;1;702;233;41;976;269;53;3;266;228;38
06.11.2022;Bürgerentscheid zur Abwahl des Oberbürgermeisters der Stadt Frankfurt am Main, Herrn Peter Feldmann;06412000;40101;401-01;1;1;684;173;56;913;298;70;3;295;241;54
06.11.2022;Bürgerentscheid zur Abwahl des Oberbürgermeisters der Stadt Frankfurt am Main, Herrn Peter Feldmann;06412000;40102;401-02;1;1;529;141;30;700;198;39;1;197;169;28
06.11.2022;Bürgerentscheid zur Abwahl des Oberbürgermeisters der Stadt Frankfurt am Main, Herrn Peter Feldmann;06412000;40103;401-03;1;1;596;234;42;872;336;104;4;332;287;45
06.11.2022;Bürgerentscheid zur Abwahl des Oberbürgermeisters der Stadt Frankfurt am Main, Herrn Peter Feldmann;06412000;40104;401-04;1;1;514;205;40;759;283;78;2;281;244;37
06.11.2022;Bürgerentscheid zur Abwahl des Oberbürgermeisters der Stadt Frankfurt am Main, Herrn Peter Feldmann;06412000;40105;401-05;1;1;722;277;53;1052;359;109;4;355;298;57
06.11.2022;Bürgerentscheid zur Abwahl des Oberbürgermeisters der Stadt Frankfurt am Main, Herrn Peter Feldmann;06412000;40201;402-01;1;1;791;254;49;1094;296;63;2;294;246;48
06.11.2022;Bürgerentscheid zur Abwahl des Oberbürgermeisters der Stadt Frankfurt am Main, Herrn Peter Feldmann;06412000;40202;402-02;1;1;768;248;50;1066;328;64;2;326;271;55
06.11.2022;Bürgerentscheid zur Abwahl des Oberbürgermeisters der Stadt Frankfurt am Main, Herrn Peter Feldmann;06412000;40203;402-03;1;1;575;249;50;874;329;85;3;326;284;42
06.11.2022;Bürgerentscheid zur Abwahl des Oberbürgermeisters der Stadt Frankfurt am Main, Herrn Peter Feldmann;06412000;40204;402-04;1;1;761;257;61;1079;463;135;4;459;396;63
06.11.2022;Bürgerentscheid zur Abwahl des Oberbürgermeisters der Stadt Frankfurt am Main, Herrn Peter Feldmann;06412000;41001;410-01;1;1;580;260;33;873;344;94;4;340;293;47
06.11.2022;Bürgerentscheid zur Abwahl des Oberbürgermeisters der Stadt Frankfurt am Main, Herrn Peter Feldmann;06412000;41002;410-02;1;1;716;284;63;1063;403;106;4;399;329;70
06.11.2022;Bürgerentscheid zur Abwahl des Oberbürgermeisters der Stadt Frankfurt am Main, Herrn Peter Feldmann;06412000;41003;410-03;1;1;586;150;35;771;190;51;2;188;162;26
06.11.2022;Bürgerentscheid zur Abwahl des Oberbürgermeisters der Stadt Frankfurt am Main, Herrn Peter Feldmann;06412000;42201;422-01;1;1;602;190;47;839;242;62;2;240;200;40
06.11.2022;Bürgerentscheid zur Abwahl des Oberbürgermeisters der Stadt Frankfurt am Main, Herrn Peter Feldmann;06412000;42202;422-02;1;1;765;220;43;1028;250;57;2;248;213;35
06.11.2022;Bürgerentscheid zur Abwahl des Oberbürgermeisters der Stadt Frankfurt am Main, Herrn Peter Feldmann;06412000;42203;422-03;1;1;621;157;40;818;205;40;2;203;171;32
06.11.2022;Bürgerentscheid zur Abwahl des Oberbürgermeisters der Stadt Frankfurt am Main, Herrn Peter Feldmann;06412000;42301;423-01;1;1;632;228;47;907;336;98;3;333;272;61
06.11.2022;Bürgerentscheid zur Abwahl des Oberbürgermeisters der Stadt Frankfurt am Main, Herrn Peter Feldmann;06412000;42302;423-02;1;1;551;156;36;743;232;44;2;230;202;28
06.11.2022;Bürgerentscheid zur Abwahl des Oberbürgermeisters der Stadt Frankfurt am Main, Herrn Peter Feldmann;06412000;42401;424-01;1;1;486;144;38;668;192;42;1;191;170;21
06.11.2022;Bürgerentscheid zur Abwahl des Oberbürgermeisters der Stadt Frankfurt am Main, Herrn Peter Feldmann;06412000;42501;425-01;1;1;586;181;40;807;225;51;2;223;198;25
06.11.2022;Bürgerentscheid zur Abwahl des Oberbürgermeisters der Stadt Frankfurt am Main, Herrn Peter Feldmann;06412000;42601;426-01;1;1;753;267;46;1066;467;103;3;464;382;82
06.11.2022;Bürgerentscheid zur Abwahl des Oberbürgermeisters der Stadt Frankfurt am Main, Herrn Peter Feldmann;06412000;42602;426-02;1;1;503;134;30;667;251;75;2;249;219;30
06.11.2022;Bürgerentscheid zur Abwahl des Oberbürgermeisters der Stadt Frankfurt am Main, Herrn Peter Feldmann;06412000;43101;431-01;1;1;554;215;35;804;269;82;2;267;218;49
06.11.2022;Bürgerentscheid zur Abwahl des Oberbürgermeisters der Stadt Frankfurt am Main, Herrn Peter Feldmann;06412000;43102;431-02;1;1;750;278;47;1075;406;115;4;402;340;62
06.11.2022;Bürgerentscheid zur Abwahl des Oberbürgermeisters der Stadt Frankfurt am Main, Herrn Peter Feldmann;06412000;43103;431-03;1;1;514;214;48;776;284;81;2;282;232;50
06.11.2022;Bürgerentscheid zur Abwahl des Oberbürgermeisters der Stadt Frankfurt am Main, Herrn Peter Feldmann;06412000;43104;431-04;1;1;723;290;40;1053;399;96;3;396;343;53
06.11.2022;Bürgerentscheid zur Abwahl des Oberbürgermeisters der Stadt Frankfurt am Main, Herrn Peter Feldmann;06412000;43105;431-05;1;1;598;214;45;857;206;59;2;204;180;24
06.11.2022;Bürgerentscheid zur Abwahl des Oberbürgermeisters der Stadt Frankfurt am Main, Herrn Peter Feldmann;06412000;43201;432-01;1;1;576;154;47;777;343;65;3;340;279;61
06.11.2022;Bürgerentscheid zur Abwahl des Oberbürgermeisters der Stadt Frankfurt am Main, Herrn Peter Feldmann;06412000;43202;432-02;1;1;718;189;56;963;375;107;4;371;306;65
06.11.2022;Bürgerentscheid zur Abwahl des Oberbürgermeisters der Stadt Frankfurt am Main, Herrn Peter Feldmann;06412000;43203;432-03;1;1;697;262;44;1003;312;95;3;309;254;55
06.11.2022;Bürgerentscheid zur Abwahl des Oberbürgermeisters der Stadt Frankfurt am Main, Herrn Peter Feldmann;06412000;43204;432-04;1;1;635;197;52;884;302;58;2;300;252;48
06.11.2022;Bürgerentscheid zur Abwahl des Oberbürgermeisters der Stadt Frankfurt am Main, Herrn Peter Feldmann;06412000;44101;441-01;1;1;687;236;59;982;228;53;2;226;196;30
06.11.2022;Bürgerentscheid zur Abwahl des Oberbürgermeisters der Stadt Frankfurt am Main, Herrn Peter Feldmann;06412000;44102;441-02;1;1;708;323;63;1094;382;116;3;379;317;62
06.11.2022;Bürgerentscheid zur Abwahl des Oberbürgermeisters der Stadt Frankfurt am Main, Herrn Peter Feldmann;06412000;44103;441-03;1;1;467;224;30;721;212;50;1;211;186;25
06.11.2022;Bürgerentscheid zur Abwahl des Oberbürgermeisters der Stadt Frankfurt am Main, Herrn Peter Feldmann;06412000;44104;441-04;1;1;599;232;39;870;342;82;3;339;290;49
06.11.2022;Bürgerentscheid zur Abwahl des Oberbürgermeisters der Stadt Frankfurt am Main, Herrn Peter Feldmann;06412000;44105;441-05;1;1;592;275;51;918;269;81;2;267;234;33
06.11.2022;Bürgerentscheid zur Abwahl des Oberbürgermeisters der Stadt Frankfurt am Main, Herrn Peter Feldmann;06412000;44106;441-06;1;1;729;287;49;1065;299;85;3;296;243;53
06.11.2022;Bürgerentscheid zur Abwahl des Oberbürgermeisters der Stadt Frankfurt am Main, Herrn Peter Feldmann;06412000;44107;441-07;1;1;534;217;39;790;220;47;2;218;187;31
06.11.2022;Bürgerentscheid zur Abwahl des Oberbürgermeisters der Stadt Frankfurt am Main, Herrn Peter Feldmann;06412000;44108;441-08;1;1;767;220;61;1048;439;111;3;436;372;64
06.11.2022;Bürgerentscheid zur Abwahl des Oberbürgermeisters der Stadt Frankfurt am Main, Herrn Peter Feldmann;06412000;44201;442-01;1;1;607;244;48;899;338;88;3;335;286;49
06.11.2022;Bürgerentscheid zur Abwahl des Oberbürgermeisters der Stadt Frankfurt am Main, Herrn Peter Feldmann;06412000;44202;442-02;1;1;534;174;32;740;293;74;2;291;242;49
06.11.2022;Bürgerentscheid zur Abwahl des Oberbürgermeisters der Stadt Frankfurt am Main, Herrn Peter Feldmann;06412000;44203;442-03;1;1;602;275;34;911;321;84;3;318;276;42
06.11.2022;Bürgerentscheid zur Abwahl des Oberbürgermeisters der Stadt Frankfurt am Main, Herrn Peter Feldmann;06412000;44204;442-04;1;1;546;146;36;728;205;56;1;204;181;23
06.11.2022;Bürgerentscheid zur Abwahl des Oberbürgermeisters der Stadt Frankfurt am Main, Herrn Peter Feldmann;06412000;45101;451-01;1;1;452;187;26;665;226;66;2;224;188;36
06.11.2022;Bürgerentscheid zur Abwahl des Oberbürgermeisters der Stadt Frankfurt am Main, Herrn Peter Feldmann;06412000;45102;451-02;1;1;488;205;33;726;254;61;2;252;213;39
06.11.2022;Bürgerentscheid zur Abwahl des Oberbürgermeisters der Stadt Frankfurt am Main, Herrn Peter Feldmann;06412000;45103;451-03;1;1;592;188;41;821;232;46;1;231;193;38
06.11.2022;Bürgerentscheid zur Abwahl des Oberbürgermeisters der Stadt Frankfurt am Main, Herrn Peter Feldmann;06412000;45104;451-04;1;1;641;209;39;889;253;54;2;251;222;29
06.11.2022;Bürgerentscheid zur Abwahl des Oberbürgermeisters der Stadt Frankfurt am Main, Herrn Peter Feldmann;06412000;45201;452-01;1;1;799;251;49;1099;334;90;3;331;285;46
06.11.2022;Bürgerentscheid zur Abwahl des Oberbürgermeisters der Stadt Frankfurt am Main, Herrn Peter Feldmann;06412000;45202;452-02;1;1;453;194;28;675;156;41;1;155;128;27
06.11.2022;Bürgerentscheid zur Abwahl des Oberbürgermeisters der Stadt Frankfurt am Main, Herrn Peter Feldmann;06412000;45203;452-03;1;1;604;273;46;923;285;74;3;282;234;48
06.11.2022;Bürgerentscheid zur Abwahl des Oberbürgermeisters der Stadt Frankfurt am Main, Herrn Peter Feldmann;06412000;45204;452-04;1;1;490;220;43;753;274;77;2;272;237;35
06.11.2022;Bürgerentscheid zur Abwahl des Oberbürgermeisters der Stadt Frankfurt am Main, Herrn Peter Feldmann;06412000;46101;461-01;1;1;426;208;35;669;241;67;1;240;203;37
06.11.2022;Bürgerentscheid zur Abwahl des Oberbürgermeisters der Stadt Frankfurt am Main, Herrn Peter Feldmann;06412000;46102;461-02;1;1;730;214;53;997;313;81;2;311;260;51
06.11.2022;Bürgerentscheid zur Abwahl des Oberbürgermeisters der Stadt Frankfurt am Main, Herrn Peter Feldmann;06412000;46103;461-03;1;1;803;242;61;1106;431;83;3;428;358;70
06.11.2022;Bürgerentscheid zur Abwahl des Oberbürgermeisters der Stadt Frankfurt am Main, Herrn Peter Feldmann;06412000;46104;461-04;1;1;712;178;55;945;297;72;3;294;256;38
06.11.2022;Bürgerentscheid zur Abwahl des Oberbürgermeisters der Stadt Frankfurt am Main, Herrn Peter Feldmann;06412000;46105;461-05;1;1;618;179;40;837;254;78;2;252;206;46
06.11.2022;Bürgerentscheid zur Abwahl des Oberbürgermeisters der Stadt Frankfurt am Main, Herrn Peter Feldmann;06412000;46106;461-06;1;1;519;210;40;769;337;71;3;334;293;41
06.11.2022;Bürgerentscheid zur Abwahl des Oberbürgermeisters der Stadt Frankfurt am Main, Herrn Peter Feldmann;06412000;46107;461-07;1;1;799;251;46;1096;330;94;4;326;272;54
06.11.2022;Bürgerentscheid zur Abwahl des Oberbürgermeisters der Stadt Frankfurt am Main, Herrn Peter Feldmann;06412000;46201;462-01;1;1;773;251;50;1074;331;98;2;329;281;48
06.11.2022;Bürgerentscheid zur Abwahl des Oberbürgermeisters der Stadt Frankfurt am Main, Herrn Peter Feldmann;06412000;46202;462-02;1;1;517;153;38;708;282;55;2;280;231;49
06.11.2022;Bürgerentscheid zur Abwahl des Oberbürgermeisters der Stadt Frankfurt am Main, Herrn Peter Feldmann;06412000;46203;462-03;1;1;730;258;40;1028;302;82;3;299;245;54
06.11.2022;Bürgerentscheid zur Abwahl des Oberbürgermeisters der Stadt Frankfurt am Main, Herrn Peter Feldmann;06412000;46204;462-04;1;1;685;313;47;1045;401;115;3;398;326;72
06.11.2022;Bürgerentscheid zur Abwahl des Oberbürgermeisters der Stadt Frankfurt am Main, Herrn Peter Feldmann;06412000;46205;462-05;1;1;540;251;37;828;311;86;2;309;259;50
06.11.2022;Bürgerentscheid zur Abwahl des Oberbürgermeisters der Stadt Frankfurt am Main, Herrn Peter Feldmann;06412000;46206;462-06;1;1;519;223;46;788;214;54;1;213;177;36
06.11.2022;Bürgerentscheid zur Abwahl des Oberbürgermeisters der Stadt Frankfurt am Main, Herrn Peter Feldmann;06412000;46301;463-01;1;1;513;205;35;753;247;46;2;245;210;35
06.11.2022;Bürgerentscheid zur Abwahl des Oberbürgermeisters der Stadt Frankfurt am Main, Herrn Peter Feldmann;06412000;46302;463-02;1;1;631;220;41;892;238;66;2;236;205;31
06.11.2022;Bürgerentscheid zur Abwahl des Oberbürgermeisters der Stadt Frankfurt am Main, Herrn Peter Feldmann;06412000;47001;470-01;1;1;488;151;32;671;165;48;1;164;144;20
06.11.2022;Bürgerentscheid zur Abwahl des Oberbürgermeisters der Stadt Frankfurt am Main, Herrn Peter Feldmann;06412000;47002;470-02;1;1;653;317;52;1022;364;72;3;361;308;53
06.11.2022;Bürgerentscheid zur Abwahl des Oberbürgermeisters der Stadt Frankfurt am Main, Herrn Peter Feldmann;06412000;47003;470-03;1;1;593;266;43;902;228;53;1;227;187;40
06.11.2022;Bürgerentscheid zur Abwahl des Oberbürgermeisters der Stadt Frankfurt am Main, Herrn Peter Feldmann;06412000;47004;470-04;1;1;482;209;30;721;244;76;2;242;200;42
06.11.2022;Bürgerentscheid zur Abwahl des Oberbürgermeisters der Stadt Frankfurt am Main, Herrn Peter Feldmann;06412000;47005;470-05;1;1;746;213;49;1008;365;89;3;362;300;62
06.11.2022;Bürgerentscheid zur Abwahl des Oberbürgermeisters der Stadt Frankfurt am Main, Herrn Peter Feldmann;06412000;47006;470-06;1;1;753;203;52;1008;301;76;3;298;251;47
06.11.2022;Bürgerentscheid zur Abwahl des Oberbürgermeisters der Stadt Frankfurt am Main, Herrn Peter Feldmann;06412000;47007;470-07;1;1;538;200;44;782;215;44;2;213;178;35
06.11.2022;Bürgerentscheid zur Abwahl des Oberbürgermeisters der Stadt Frankfurt am Main, Herrn Peter Feldmann;06412000;48101;481-01;1;1;621;281;46;948;357;76;3;354;298;56
06.11.2022;Bürgerentscheid zur Abwahl des Oberbürgermeisters der Stadt Frankfurt am Main, Herrn Peter Feldmann;06412000;48102;481-02;1;1;568;155;38;761;280;60;3;277;243;34
06.11.2022;Bürgerentscheid zur Abwahl des Oberbürgermeisters der Stadt Frankfurt am Main, Herrn Peter Feldmann;06412000;48103;481-03;1;1;698;172;45;915;304;64;2;302;251;51
06.11.2022;Bürgerentscheid zur Abwahl des Oberbürgermeisters der Stadt Frankfurt am Main, Herrn Peter Feldmann;06412000;48201;482-01;1;1;472;216;44;732;211;48;2;209;171;38
06.11.2022;Bürgerentscheid zur Abwahl des Oberbürgermeisters der Stadt Frankfurt am Main, Herrn Peter Feldmann;06412000;48202;482-02;1;1;718;227;55;1000;243;68;2;241;199;42
06.11.2022;Bürgerentscheid zur Abwahl des Oberbürgermeisters der Stadt Frankfurt am Main, Herrn Peter Feldmann;06412000;48203;482-03;1;1;513;126;32;671;216;43;2;214;184;30
06.11.2022;Bürgerentscheid zur Abwahl des Oberbürgermeisters der Stadt Frankfurt am Main, Herrn Peter Feldmann;06412000;48301;483-01;1;1;559;238;37;834;310;58;2;308;263;45
06.11.2022;Bürgerentscheid zur Abwahl des Oberbürgermeisters der Stadt Frankfurt am Main, Herrn Peter Feldmann;06412000;49101;491-01;1;1;477;233;43;753;298;73;2;296;260;36
06.11.2022;Bürgerentscheid zur Abwahl des Oberbürgermeisters der Stadt Frankfurt am Main, Herrn Peter Feldmann;06412000;49102;491-02;1;1;608;283;50;941;324;83;3;321;269;52
06.11.2022;Bürgerentscheid zur Abwahl des Oberbürgermeisters der Stadt Frankfurt am Main, Herrn Peter Feldmann;06412000;49103;491-03;1;1;488;174;35;697;256;68;2;254;210;44
06.11.2022;Bürgerentscheid zur Abwahl des Oberbürgermeisters der Stadt Frankfurt am Main, Herrn Peter Feldmann;06412000;49201;492-01;1;1;680;167;43;890;305;88;2;303;253;50
06.11.2022;Bürgerentscheid zur Abwahl des Oberbürgermeisters der Stadt Frankfurt am Main, Herrn Peter Feldmann;06412000;49202;492-02;1;1;667;200;45;912;299;64;2;297;250;47
06.11.2022;Bürgerentscheid zur Abwahl des Oberbürgermeisters der Stadt Frankfurt am Main, Herrn Peter Feldmann;06412000;49203;492-03;1;1;729;300;57;1086;386;77;4;382;332;50
06.11.2022;Bürgerentscheid zur Abwahl des Oberbürgermeisters der Stadt Frankfurt am Main, Herrn Peter Feldmann;06412000;49204;492-04;1;1;474;178;39;691;276;51;2;274;237;37
06.11.2022;Bürgerentscheid zur Abwahl des Oberbürgermeisters der Stadt Frankfurt am Main, Herrn Peter Feldmann;06412000;50001;500-01;1;1;473;176;41;690;263;69;2;261;213;48
06.11.2022;Bürgerentscheid zur Abwahl des Oberbürgermeisters der Stadt Frankfurt am Main, Herrn Peter Feldmann;06412000;50002;500-02;1;1;517;253;41;811;331;102;2;329;277;52
06.11.2022;Bürgerentscheid zur Abwahl des Oberbürgermeisters der Stadt Frankfurt am Main, Herrn Peter Feldmann;06412000;51001;510-01;1;1;607;296;51;954;370;73;2;368;315;53
06.11.2022;Bürgerentscheid zur Abwahl des Oberbürgermeisters der Stadt Frankfurt am Main, Herrn Peter Feldmann;06412000;51002;510-02;1;1;578;237;32;847;326;66;3;323;285;38
06.11.2022;Bürgerentscheid zur Abwahl des Oberbürgermeisters der Stadt Frankfurt am Main, Herrn Peter Feldmann;06412000;51003;510-03;1;1;676;236;36;948;329;67;3;326;282;44
06.11.2022;Bürgerentscheid zur Abwahl des Oberbürgermeisters der Stadt Frankfurt am Main, Herrn Peter Feldmann;06412000;51004;510-04;1;1;488;149;39;676;247;53;2;245;212;33
06.11.2022;Bürgerentscheid zur Abwahl des Oberbürgermeisters der Stadt Frankfurt am Main, Herrn Peter Feldmann;06412000;52001;520-01;1;1;587;286;48;921;318;89;3;315;272;43
06.11.2022;Bürgerentscheid zur Abwahl des Oberbürgermeisters der Stadt Frankfurt am Main, Herrn Peter Feldmann;06412000;52002;520-02;1;1;504;195;40;739;228;46;2;226;186;40
06.11.2022;Bürgerentscheid zur Abwahl des Oberbürgermeisters der Stadt Frankfurt am Main, Herrn Peter Feldmann;06412000;52003;520-03;1;1;475;218;42;735;229;62;2;227;200;27
06.11.2022;Bürgerentscheid zur Abwahl des Oberbürgermeisters der Stadt Frankfurt am Main, Herrn Peter Feldmann;06412000;53101;531-01;1;1;568;167;48;783;231;47;2;229;191;38
06.11.2022;Bürgerentscheid zur Abwahl des Oberbürgermeisters der Stadt Frankfurt am Main, Herrn Peter Feldmann;06412000;53102;531-02;1;1;616;150;33;799;213;43;1;212;178;34
06.11.2022;Bürgerentscheid zur Abwahl des Oberbürgermeisters der Stadt Frankfurt am Main, Herrn Peter Feldmann;06412000;53103;531-03;1;1;770;218;61;1049;375;92;3;372;318;54
06.11.2022;Bürgerentscheid zur Abwahl des Oberbürgermeisters der Stadt Frankfurt am Main, Herrn Peter Feldmann;06412000;53104;531-04;1;1;641;169;40;850;288;84;3;285;245;40
06.11.2022;Bürgerentscheid zur Abwahl des Oberbürgermeisters der Stadt Frankfurt am Main, Herrn Peter Feldmann;06412000;53105;531-05;1;1;791;235;47;1073;278;74;2;276;236;40
06.11.2022;Bürgerentscheid zur Abwahl des Oberbürgermeisters der Stadt Frankfurt am Main, Herrn Peter Feldmann;06412000;53201;532-01;1;1;461;198;33;692;263;81;2;261;228;33
06.11.2022;Bürgerentscheid zur Abwahl des Oberbürgermeisters der Stadt Frankfurt am Main, Herrn Peter Feldmann;06412000;53202;532-02;1;1;683;228;50;961;289;55;3;286;235;51
06.11.2022;Bürgerentscheid zur Abwahl des Oberbürgermeisters der Stadt Frankfurt am Main, Herrn Peter Feldmann;06412000;53203;532-03;1;1;577;214;49;840;337;73;2;335;290;45
06.11.2022;Bürgerentscheid zur Abwahl des Oberbürgermeisters der Stadt Frankfurt am Main, Herrn Peter Feldmann;06412000;53204;532-04;1;1;837;212;49;1098;459;140;4;455;400;55
06.11.2022;Bürgerentscheid zur Abwahl des Oberbürgermeisters der Stadt Frankfurt am Main, Herrn Peter Feldmann;06412000;53205;532-05;1;1;584;176;35;795;258;54;2;256;211;45
06.11.2022;Bürgerentscheid zur Abwahl des Oberbürgermeisters der Stadt Frankfurt am Main, Herrn Peter Feldmann;06412000;53206;532-06;1;1;741;212;57;1010;390;93;3;387;325;62
06.11.2022;Bürgerentscheid zur Abwahl des Oberbürgermeisters der Stadt Frankfurt am Main, Herrn Peter Feldmann;06412000;54101;541-01;1;1;667;227;55;949;355;94;4;351;311;40
06.11.2022;Bürgerentscheid zur Abwahl des Oberbürgermeisters der Stadt Frankfurt am Main, Herrn Peter Feldmann;06412000;54102;541-02;1;1;667;257;50;974;278;56;2;276;225;51
06.11.2022;Bürgerentscheid zur Abwahl des Oberbürgermeisters der Stadt Frankfurt am Main, Herrn Peter Feldmann;06412000;54201;542-01;1;1;672;253;56;981;373;100;4;369;321;48
06.11.2022;Bürgerentscheid zur Abwahl des Oberbürgermeisters der Stadt Frankfurt am Main, Herrn Peter Feldmann;06412000;54202;542-02;1;1;718;181;40;939;256;50;3;253;209;44
06.11.2022;Bürgerentscheid zur Abwahl des Oberbürgermeisters der Stadt Frankfurt am Main, Herrn Peter Feldmann;06412000;54203;542-03;1;1;600;211;34;845;314;72;2;312;257;55
06.11.2022;Bürgerentscheid zur Abwahl des Oberbürgermeisters der Stadt Frankfurt am Main, Herrn Peter Feldmann;06412000;55101;551-01;1;1;759;294;43;1096;364;81;3;361;321;40
06.11.2022;Bürgerentscheid zur Abwahl des Oberbürgermeisters der Stadt Frankfurt am Main, Herrn Peter Feldmann;06412000;55102;551-02;1;1;624;239;55;918;380;81;3;377;314;63
06.11.2022;Bürgerentscheid zur Abwahl des Oberbürgermeisters der Stadt Frankfurt am Main, Herrn Peter Feldmann;06412000;55201;552-01;1;1;743;268;67;1078;290;64;3;287;242;45
06.11.2022;Bürgerentscheid zur Abwahl des Oberbürgermeisters der Stadt Frankfurt am Main, Herrn Peter Feldmann;06412000;55202;552-02;1;1;622;183;40;845;312;82;2;310;262;48
06.11.2022;Bürgerentscheid zur Abwahl des Oberbürgermeisters der Stadt Frankfurt am Main, Herrn Peter Feldmann;06412000;55203;552-03;1;1;492;210;45;747;220;57;2;218;194;24
06.11.2022;Bürgerentscheid zur Abwahl des Oberbürgermeisters der Stadt Frankfurt am Main, Herrn Peter Feldmann;06412000;56101;561-01;1;1;532;133;35;700;195;50;1;194;168;26
06.11.2022;Bürgerentscheid zur Abwahl des Oberbürgermeisters der Stadt Frankfurt am Main, Herrn Peter Feldmann;06412000;56102;561-02;1;1;552;165;30;747;301;74;2;299;260;39
06.11.2022;Bürgerentscheid zur Abwahl des Oberbürgermeisters der Stadt Frankfurt am Main, Herrn Peter Feldmann;06412000;56103;561-03;1;1;532;176;35;743;260;63;2;258;227;31
06.11.2022;Bürgerentscheid zur Abwahl des Oberbürgermeisters der Stadt Frankfurt am Main, Herrn Peter Feldmann;06412000;56104;561-04;1;1;780;196;45;1021;387;117;4;383;324;59
06.11.2022;Bürgerentscheid zur Abwahl des Oberbürgermeisters der Stadt Frankfurt am Main, Herrn Peter Feldmann;06412000;56105;561-05;1;1;802;205;65;1072;401;111;4;397;348;49
06.11.2022;Bürgerentscheid zur Abwahl des Oberbürgermeisters der Stadt Frankfurt am Main, Herrn Peter Feldmann;06412000;56201;562-01;1;1;658;298;57;1013;394;105;4;390;327;63
06.11.2022;Bürgerentscheid zur Abwahl des Oberbürgermeisters der Stadt Frankfurt am Main, Herrn Peter Feldmann;06412000;56202;562-02;1;1;610;179;40;829;298;89;2;296;252;44
06.11.2022;Bürgerentscheid zur Abwahl des Oberbürgermeisters der Stadt Frankfurt am Main, Herrn Peter Feldmann;06412000;56203;562-03;1;1;480;191;30;701;238;53;2;236;192;44
06.11.2022;Bürgerentscheid zur Abwahl des Oberbürgermeisters der Stadt Frankfurt am Main, Herrn Peter Feldmann;06412000;56204;562-04;1;1;752;192;53;997;265;77;2;263;217;46
06.11.2022;Bürgerentscheid zur Abwahl des Oberbürgermeisters der Stadt Frankfurt am Main, Herrn Peter Feldmann;06412000;57001;570-01;1;1;597;265;33;895;345;95;3;342;289;53
06.11.2022;Bürgerentscheid zur Abwahl des Oberbürgermeisters der Stadt Frankfurt am Main, Herrn Peter Feldmann;06412000;57002;570-02;1;1;686;176;33;895;350;76;3;347;286;61
06.11.2022;Bürgerentscheid zur Abwahl des Oberbürgermeisters der Stadt Frankfurt am Main, Herrn Peter Feldmann;06412000;57003;570-03;1;1;578;240;50;868;290;89;2;288;255;33
06.11.2022;Bürgerentscheid zur Abwahl des Oberbürgermeisters der Stadt Frankfurt am Main, Herrn Peter Feldmann;06412000;58001;580-01;1;1;623;242;50;915;370;103;4;366;322;44
06.11.2022;Bürgerentscheid zur Abwahl des Oberbürgermeisters der Stadt Frankfurt am Main, Herrn Peter Feldmann;06412000;58002;580-02;1;1;533;207;45;785;196;54;1;195;163;32
06.11.2022;Bürgerentscheid zur Abwahl des Oberbürgermeisters der Stadt Frankfurt am Main, Herrn Peter Feldmann;06412000;59101;591-01;1;1;706;297;61;1064;312;73;2;310;271;39
06.11.2022;Bürgerentscheid zur Abwahl des Oberbürgermeisters der Stadt Frankfurt am Main, Herrn Peter Feldmann;06412000;59102;591-02;1;1;604;236;54;894;218;54;2;216;188;28
06.11.2022;Bürgerentscheid zur Abwahl des Oberbürgermeisters der Stadt Frankfurt am Main, Herrn Peter Feldmann;06412000;60101;601-01;1;1;466;175;27;668;185;57;1;184;159;25
06.11.2022;Bürgerentscheid zur Abwahl des Oberbürgermeisters der Stadt Frankfurt am Main, Herrn Peter Feldmann;06412000;60102;601-02;1;1;588;233;40;861;302;63;2;300;253;47
06.11.2022;Bürgerentscheid zur Abwahl des Oberbürgermeisters der Stadt Frankfurt am Main, Herrn Peter Feldmann;06412000;60201;602-01;1;1;757;245;41;1043;341;85;2;339;295;44
06.11.2022;Bürgerentscheid zur Abwahl des Oberbürgermeisters der Stadt Frankfurt am Main, Herrn Peter Feldmann;06412000;60202;602-02;1;1;728;296;45;1069;266;73;2;264;225;39
06.11.2022;Bürgerentscheid zur Abwahl des Oberbürgermeisters der Stadt Frankfurt am Main, Herrn Peter Feldmann;06412000;60401;604-01;1;1;505;163;26;694;265;53;2;263;224;39
06.11.2022;Bürgerentscheid zur Abwahl des Oberbürgermeisters der Stadt Frankfurt am Main, Herrn Peter Feldmann;06412000;61101;611-01;1;1;769;191;58;1018;305;69;3;302;257;45
06.11.2022;Bürgerentscheid zur Abwahl des Oberbürgermeisters der Stadt Frankfurt am Main, Herrn Peter Feldmann;06412000;61102;611-02;1;1;650;291;45;986;243;63;2;241;203;38
06.11.2022;Bürgerentscheid zur Abwahl des Oberbürgermeisters der Stadt Frankfurt am Main, Herrn Peter Feldmann;06412000;61201;612-01;1;1;649;224;36;909;250;51;2;248;217;31
06.11.2022;Bürgerentscheid zur Abwahl des Oberbürgermeisters der Stadt Frankfurt am Main, Herrn Peter Feldmann;06412000;61202;612-02;1;1;706;240;62;1008;395;117;4;391;341;50
06.11.2022;Bürgerentscheid zur Abwahl des Oberbürgermeisters der Stadt Frankfurt am Main, Herrn Peter Feldmann;06412000;62101;621-01;1;1;505;177;32;714;187;56;1;186;153;33
06.11.2022;Bürgerentscheid zur Abwahl des Oberbürgermeisters der Stadt Frankfurt am Main, Herrn Peter Feldmann;06412000;62102;621-02;1;1;451;187;28;666;154;43;1;153;135;18
06.11.2022;Bürgerentscheid zur Abwahl des Oberbürgermeisters der Stadt Frankfurt am Main, Herrn Peter Feldmann;06412000;62103;621-03;1;1;653;191;49;893;322;95;3;319;272;47
06.11.2022;Bürgerentscheid zur Abwahl des Oberbürgermeisters der Stadt Frankfurt am Main, Herrn Peter Feldmann;06412000;62104;621-04;1;1;518;256;50;824;287;60;2;285;246;39
06.11.2022;Bürgerentscheid zur Abwahl des Oberbürgermeisters der Stadt Frankfurt am Main, Herrn Peter Feldmann;06412000;62201;622-01;1;1;646;191;43;880;274;69;3;271;238;33
06.11.2022;Bürgerentscheid zur Abwahl des Oberbürgermeisters der Stadt Frankfurt am Main, Herrn Peter Feldmann;06412000;62202;622-02;1;1;770;190;42;1002;328;101;2;326;276;50
06.11.2022;Bürgerentscheid zur Abwahl des Oberbürgermeisters der Stadt Frankfurt am Main, Herrn Peter Feldmann;06412000;62203;622-03;1;1;650;186;32;868;329;80;3;326;272;54
06.11.2022;Bürgerentscheid zur Abwahl des Oberbürgermeisters der Stadt Frankfurt am Main, Herrn Peter Feldmann;06412000;63101;631-01;1;1;467;218;32;717;247;53;2;245;212;33
06.11.2022;Bürgerentscheid zur Abwahl des Oberbürgermeisters der Stadt Frankfurt am Main, Herrn Peter Feldmann;06412000;63102;631-02;1;1;631;258;39;928;253;69;2;251;219;32
06.11.2022;Bürgerentscheid zur Abwahl des Oberbürgermeisters der Stadt Frankfurt am Main, Herrn Peter Feldmann;06412000;63103;631-03;1;1;599;248;48;895;244;59;2;242;212;30
06.11.2022;Bürgerentscheid zur Abwahl des Oberbürgermeisters der Stadt Frankfurt am Main, Herrn Peter Feldmann;06412000;63104;631-04;1;1;535;249;31;815;325;69;3;322;285;37
06.11.2022;Bürgerentscheid zur Abwahl des Oberbürgermeisters der Stadt Frankfurt am Main, Herrn Peter Feldmann;06412000;63201;632-01;1;1;644;185;51;880;237;62;1;236;202;34
06.11.2022;Bürgerentscheid zur Abwahl des Oberbürgermeisters der Stadt Frankfurt am Main, Herrn Peter Feldmann;06412000;63202;632-02;1;1;482;209;28;719;200;49;1;199;166;33
06.11.2022;Bürgerentscheid zur Abwahl des Oberbürgermeisters der Stadt Frankfurt am Main, Herrn Peter Feldmann;06412000;63203;632-03;1;1;693;300;56;1049;361;87;4;357;296;61
06.11.2022;Bürgerentscheid zur Abwahl des Oberbürgermeisters der Stadt Frankfurt am Main, Herrn Peter Feldmann;06412000;64001;640-01;1;1;619;178;44;841;273;68;2;271;231;40
06.11.2022;Bürgerentscheid zur Abwahl des Oberbürgermeisters der Stadt Frankfurt am Main, Herrn Peter Feldmann;06412000;64002;640-02;1;1;769;244;58;1071;465;131;5;460;390;70
06.11.2022;Bürgerentscheid zur Abwahl des Oberbürgermeisters der Stadt Frankfurt am Main, Herrn Peter Feldmann;06412000;64003;640-03;1;1;543;249;38;830;288;88;3;285;245;40
06.11.2022;Bürgerentscheid zur Abwahl des Oberbürgermeisters der Stadt Frankfurt am Main, Herrn Peter Feldmann;06412000;65001;650-01;1;1;788;257;45;1090;312;86;2;310;269;41
06.11.2022;Bürgerentscheid zur Abwahl des Oberbürgermeisters der Stadt Frankfurt am Main, Herrn Peter Feldmann;06412000;65002;650-02;1;1;587;248;34;869;268;70;3;265;232;33
06.11.2022;Bürgerentscheid zur Abwahl des Oberbürgermeisters der Stadt Frankfurt am Main, Herrn Peter Feldmann;06412000;65003;650-03;1;1;739;248;47;1034;329;94;3;326;266;60
06.11.2022;Bürgerentscheid zur Abwahl des Oberbürgermeisters der Stadt Frankfurt am Main, Herrn Peter Feldmann;06412000;65101;651-01;1;1;732;211;47;990;297;59;2;295;244;51
06.11.2022;Bürgerentscheid zur Abwahl des Oberbürgermeisters der Stadt Frankfurt am Main, Herrn Peter Feldmann;06412000;65102;651-02;1;1;711;203;41;955;342;98;3;339;294;45
06.11.2022;Bürgerentscheid zur Abwahl des Oberbürgermeisters der Stadt Frankfurt am Main, Herrn Peter Feldmann;06412000;65103;651-03;1;1;498;180;39;717;188;45;1;187;161;26
06.11.2022;Bürgerentscheid zur Abwahl des Oberbürgermeisters der Stadt Frankfurt am Main, Herrn Peter Feldmann;06412000;65104;651-04;1;1;547;161;46;754;304;70;3;301;258;43
06.11.2022;Bürgerentscheid zur Abwahl des Oberbürgermeisters der Stadt Frankfurt am Main, Herrn Peter Feldmann;06412000;65105;651-05;1;1;624;167;48;839;221;66;2;219;192;27
06.11.2022;Bürgerentscheid zur Abwahl des Oberbürgermeisters der Stadt Frankfurt am Main, Herrn Peter Feldmann;06412000;65106;651-06;1;1;722;252;40;1014;429;115;5;424;357;67
06.11.2022;Bürgerentscheid zur Abwahl des Oberbürgermeisters der Stadt Frankfurt am Main, Herrn Peter Feldmann;06412000;65107;651-07;1;1;493;200;27;720;213;62;2;211;181;30
06.11.2022;Bürgerentscheid zur Abwahl des Oberbürgermeisters der Stadt Frankfurt am Main, Herrn Peter Feldmann;06412000;66001;660-01;1;1;512;208;34;754;223;54;2;221;185;36
06.11.2022;Bürgerentscheid zur Abwahl des Oberbürgermeisters der Stadt Frankfurt am Main, Herrn Peter Feldmann;06412000;66002;660-02;1;1;778;259;44;1081;381;85;3;378;310;68
06.11.2022;Bürgerentscheid zur Abwahl des Oberbürgermeisters der Stadt Frankfurt am Main, Herrn Peter Feldmann;06412000;66003;660-03;1;1;574;212;52;838;311;69;3;308;260;48
06.11.2022;Bürgerentscheid zur Abwahl des Oberbürgermeisters der Stadt Frankfurt am Main, Herrn Peter Feldmann;06412000;67001;670-01;1;1;553;190;29;772;244;55;2;242;202;40
06.11.2022;Bürgerentscheid zur Abwahl des Oberbürgermeisters der Stadt Frankfurt am Main, Herrn Peter Feldmann;06412000;67002;670-02;1;1;773;268;65;1106;399;119;3;396;327;69
06.11.2022;Bürgerentscheid zur Abwahl des Oberbürgermeisters der Stadt Frankfurt am Main, Herrn Peter Feldmann;06412000;67003;670-03;1;1;604;230;33;867;237;70;2;235;209;26
06.11.2022;Bürgerentscheid zur Abwahl des Oberbürgermeisters der Stadt Frankfurt am Main, Herrn Peter Feldmann;06412000;67004;670-04;1;1;604;170;34;808;324;87;3;321;271;50
06.11.2022;Bürgerentscheid zur Abwahl des Oberbürgermeisters der Stadt Frankfurt am Main, Herrn Peter Feldmann;06412000;67005;670-05;1;1;557;251;37;845;268;64;2;266;230;36
06.11.2022;Bürgerentscheid zur Abwahl des Oberbürgermeisters der Stadt Frankfurt am Main, Herrn Peter Feldmann;06412000;67006;670-06;1;1;516;169;43;728;266;73;3;263;226;37
06.11.2022;Bürgerentscheid zur Abwahl des Oberbürgermeisters der Stadt Frankfurt am Main, Herrn Peter Feldmann;06412000;68001;680-01;1;1;695;338;65;1098;401;125;4;397;342;55
06.11.2022;Bürgerentscheid zur Abwahl des Oberbürgermeisters der Stadt Frankfurt am Main, Herrn Peter Feldmann;06412000;68002;680-02;1;1;490;151;32;673;237;45;1;236;203;33
06.11.2022;Bürgerentscheid zur Abwahl des Oberbürgermeisters der Stadt Frankfurt am Main, Herrn Peter Feldmann;06412000;68003;680-03;1;1;452;205;33;690;259;56;1;258;227;31
06.11.2022;Bürgerentscheid zur Abwahl des Oberbürgermeisters der Stadt Frankfurt am Main, Herrn Peter Feldmann;06412000;68004;680-04;1;1;625;244;41;910;283;74;3;280;237;43
06.11.2022;Bürgerentscheid zur Abwahl des Oberbürgermeisters der Stadt Frankfurt am Main, Herrn Peter Feldmann;06412000;68005;680-05;1;1;770;213;55;1038;255;78;2;253;217;36
06.11.2022;Bürgerentscheid zur Abwahl des Oberbürgermeisters der Stadt Frankfurt am Main, Herrn Peter Feldmann;06412000;68006;680-06;1;1;675;322;40;1037;319;66;3;316;274;42
06.11.2022;Bürgerentscheid zur Abwahl des Oberbürgermeisters der Stadt Frankfurt am Main, Herrn Peter Feldmann;06412000;68007;680-07;1;1;600;166;40;806;277;68;3;274;234;40
06.11.2022;Bürgerentscheid zur Abwahl des Oberbürgermeisters der Stadt Frankfurt am Main, Herrn Peter Feldmann;06412000;68008;680-08;1;1;755;219;54;1028;361;92;3;358;308;50
06.11.2022;Bürgerentscheid zur Abwahl des Oberbürgermeisters der Stadt Frankfurt am Main, Herrn Peter Feldmann;06412000;68009;680-09;1;1;669;251;60;980;257;64;2;255;221;34
06.11.2022;Bürgerentscheid zur Abwahl des Oberbürgermeisters der Stadt Frankfurt am Main, Herrn Peter Feldmann;06412000;68010;680-10;1;1;651;284;59;994;246;51;2;244;216;28
06.11.2022;Bürgerentscheid zur Abwahl des Oberbürgermeisters der Stadt Frankfurt am Main, Herrn Peter Feldmann;06412000;90101;901-01;1;1;544;243;33;820;219;66;2;217;189;28
06.11.2022;Bürgerentscheid zur Abwahl des Oberbürgermeisters der Stadt Frankfurt am Main, Herrn Peter Feldmann;06412000;90201;902-01;1;1;712;185;52;949;370;91;4;366;314;52
06.11.2022;Bürgerentscheid zur Abwahl des Oberbürgermeisters der Stadt Frankfurt am Main, Herrn Peter Feldmann;06412000;90202;902-02;1;1;485;233;45;763;292;87;2;290;244;46
06.11.2022;Bürgerentscheid zur Abwahl des Oberbürgermeisters der Stadt Frankfurt am Main, Herrn Peter Feldmann;06412000;90401;904-01;1;1;610;261;55;926;288;82;2;286;251;35
06.11.2022;Bürgerentscheid zur Abwahl des Oberbürgermeisters der Stadt Frankfurt am Main, Herrn Peter Feldmann;06412000;90402;904-02;1;1;709;225;38;972;238;73;2;236;195;41
06.11.2022;Bürgerentscheid zur Abwahl des Oberbürgermeisters der Stadt Frankfurt am Main, Herrn Peter Feldmann;06412000;90403;904-03;1;1;664;182;33;879;291;69;2;289;241;48
06.11.2022;Bürgerentscheid zur Abwahl des Oberbürgermeisters der Stadt Frankfurt am Main, Herrn Peter Feldmann;06412000;90404;904-04;1;1;692;245;48;985;308;73;2;306;249;57
06.11.2022;Bürgerentscheid zur Abwahl des Oberbürgermeisters der Stadt Frankfurt am Main, Herrn Peter Feldmann;06412000;90405;904-05;1;1;703;310;53;1066;272;57;2;270;227;43
06.11.2022;Bürgerentscheid zur Abwahl des Oberbürgermeisters der Stadt Frankfurt am Main, Herrn Peter Feldmann;06412000;90501;905-01;1;1;728;244;50;1022;343;90;3;340;297;43
06.11.2022;Bürgerentscheid zur Abwahl des Oberbürgermeisters der Stadt Frankfurt am Main, Herrn Peter Feldmann;06412000;90502;905-02;1;1;496;178;28;702;209;46;2;207;183;24
06.11.2022;Bürgerentscheid zur Abwahl des Oberbürgermeisters der Stadt Frankfurt am Main, Herrn Peter Feldmann;06412000;90503;905-03;1;1;620;216;42;878;334;73;3;331;292;39
06.11.2022;Bürgerentscheid zur Abwahl des Oberbürgermeisters der Stadt Frankfurt am Main, Herrn Peter Feldmann;06412000;90601;906-01;1;1;703;227;61;991;289;80;3;286;246;40
06.11.2022;Bürgerentscheid zur Abwahl des Oberbürgermeisters der Stadt Frankfurt am Main, Herrn Peter Feldmann;06412000;90602;906-02;1;1;550;248;48;846;242;63;2;240;198;42
06.11.2022;Bürgerentscheid zur Abwahl des Oberbürgermeisters der Stadt Frankfurt am Main, Herrn Peter Feldmann;06412000;90603;906-03;1;1;578;162;33;773;227;43;1;226;190;36
06.11.2022;Bürgerentscheid zur Abwahl des Oberbürgermeisters der Stadt Frankfurt am Main, Herrn Peter Feldmann;06412000;90604;906-04;1;1;602;235;52;889;367;93;4;363;322;41
06.11.2022;Bürgerentscheid zur Abwahl des Oberbürgermeisters der Stadt Frankfurt am Main, Herrn Peter Feldmann;06412000;90605;906-05;1;1;592;232;36;860;292;71;3;289;246;43
06.11.2022;Bürgerentscheid zur Abwahl des Oberbürgermeisters der Stadt Frankfurt am Main, Herrn Peter Feldmann;06412000;90606;906-06;1;1;569;243;31;843;294;84;3;291;254;37
06.11.2022;Bürgerentscheid zur Abwahl des Oberbürgermeisters der Stadt Frankfurt am Main, Herrn Peter Feldmann;06412000;90607;906-07;1;1;585;273;35;893;261;76;1;260;222;38
06.11.2022;Bürgerentscheid zur Abwahl des Oberbürgermeisters der Stadt Frankfurt am Main, Herrn Peter Feldmann;06412000;90608;906-08;1;1;552;253;47;852;298;71;3;295;251;44
06.11.2022;Bürgerentscheid zur Abwahl des Oberbürgermeisters der Stadt Frankfurt am Main, Herrn Peter Feldmann;06412000;90609;906-09;1;1;480;173;28;681;196;46;2;194;159;35
06.11.2022;Bürgerentscheid zur Abwahl des Oberbürgermeisters der Stadt Frankfurt am Main, Herrn Peter Feldmann;06412000;90701;907-01;1;1;600;250;40;890;301;62;2;299;255;44
06.11.2022;Bürgerentscheid zur Abwahl des Oberbürgermeisters der Stadt Frankfurt am Main, Herrn Peter Feldmann;06412000;90702;907-02;1;1;658;161;33;852;250;48;2;248;212;36
06.11.2022;Bürgerentscheid zur Abwahl des Oberbürgermeisters der Stadt Frankfurt am Main, Herrn Peter Feldmann;06412000;90703;907-03;1;1;483;217;37;737;224;49;2;222;193;29
06.11.2022;Bürgerentscheid zur Abwahl des Oberbürgermeisters der Stadt Frankfurt am Main, Herrn Peter Feldmann;06412000;90704;907-04;1;1;644;162;44;850;260;77;2;258;221;37
06.11.2022;Bürgerentscheid zur Abwahl des Oberbürgermeisters der Stadt Frankfurt am Main, Herrn Peter Feldmann;06412000;90705;907-05;1;1;627;289;59;975;330;101;3;327;278;49
06.11.2022;Bürgerentscheid zur Abwahl des Oberbürgermeisters der Stadt Frankfurt am Main, Herrn Peter Feldmann;06412000;90706;907-06;1;1;805;209;61;1075;379;77;4;375;313;62
06.11.2022;Bürgerentscheid zur Abwahl des Oberbürgermeisters der Stadt Frankfurt am Main, Herrn Peter Feldmann;06412000;90707;907-07;1;1;609;232;48;889;246;47;2;244;216;28
06.11.2022;Bürgerentscheid zur Abwahl des Oberbürgermeisters der Stadt Frankfurt am Main, Herrn Peter Feldmann;06412000;90801;908-01;1;1;577;271;51;899;283;66;2;281;240;41
06.11.2022;Bürgerentscheid zur Abwahl des Oberbürgermeisters der Stadt Frankfurt am Main, Herrn Peter Feldmann;06412000;90802;908-02;1;1;587;161;38;786;268;75;2;266;227;39
06.11.2022;Bürgerentscheid zur Abwahl des Oberbürgermeisters der Stadt Frankfurt am Main, Herrn Peter Feldmann;06412000;90803;908-03;1;1;789;201;42;1032;366;75;2;364;306;58
06.11.2022;Bürgerentscheid zur Abwahl des Oberbürgermeisters der Stadt Frankfurt am Main, Herrn Peter Feldmann;06412000;90804;908-04;1;1;506;249;43;798;287;75;3;284;239;45
06.11.2022;Bürgerentscheid zur Abwahl des Oberbürgermeisters der Stadt Frankfurt am Main, Herrn Peter Feldmann;06412000;90805;908-05;1;1;677;177;47;901;333;97;3;330;292;38
06.11.2022;Bürgerentscheid zur Abwahl des Oberbürgermeisters der Stadt Frankfurt am Main, Herrn Peter Feldmann;06412000;90806;908-06;1;1;507;135;33;675;212;49;2;210;176;34
06.11.2022;Bürgerentscheid zur Abwahl des Oberbürgermeisters der Stadt Frankfurt am Main, Herrn Peter Feldmann;06412000;90807;908-07;1;1;579;238;41;858;298;88;3;295;251;44
06.11.2022;Bürgerentscheid zur Abwahl des Oberbürgermeisters der Stadt Frankfurt am Main, Herrn Peter Feldmann;06412000;90808;908-08;1;1;680;207;50;937;238;69;2;236;209;27
06.11.2022;Bürgerentscheid zur Abwahl des Oberbürgermeisters der Stadt Frankfurt am Main, Herrn Peter Feldmann;06412000;90809;908-09;1;1;681;280;55;1016;351;73;2;349;290;59
06.11.2022;Bürgerentscheid zur Abwahl des Oberbürgermeisters der Stadt Frankfurt am Main, Herrn Peter Feldmann;06412000;90901;909-01;1;1;545;145;28;718;200;40;2;198;175;23
06.11.2022;Bürgerentscheid zur Abwahl des Oberbürgermeisters der Stadt Frankfurt am Main, Herrn Peter Feldmann;06412000;90902;909-02;1;1;533;204;38;775;298;68;3;295;262;33
06.11.2022;Bürgerentscheid zur Abwahl des Oberbürgermeisters der Stadt Frankfurt am Main, Herrn Peter Feldmann;06412000;90903;909-03;1;1;587;287;49;923;346;96;4;342;294;48
06.11.2022;Bürgerentscheid zur Abwahl des Oberbürgermeisters der Stadt Frankfurt am Main, Herrn Peter Feldmann;06412000;90904;909-04;1;1;782;262;63;1107;315;65;2;313;263;50
06.11.2022;Bürgerentscheid zur Abwahl des Oberbürgermeisters der Stadt Frankfurt am Main, Herrn Peter Feldmann;06412000;90905;909-05;1;1;596;155;38;789;268;52;2;266;217;49
06.11.2022;Bürgerentscheid zur Abwahl des Oberbürgermeisters der Stadt Frankfurt am Main, Herrn Peter Feldmann;06412000;90906;909-06;1;1;639;183;32;854;274;65;2;272;233;39
06.11.2022;Bürgerentscheid zur Abwahl des Oberbürgermeisters der Stadt Frankfurt am Main, Herrn Peter Feldmann;06412000;90907;909-07;1;1;571;148;45;764;225;65;1;224;194;30
06.11.2022;Bürgerentscheid zur Abwahl des Oberbürgermeisters der Stadt Frankfurt am Main, Herrn Peter Feldmann;06412000;90908;909-08;1;1;716;210;43;969;349;100;2;347;306;41
06.11.2022;Bürgerentscheid zur Abwahl des Oberbürgermeisters der Stadt Frankfurt am Main, Herrn Peter Feldmann;06412000;90909;909-09;1;1;496;147;37;680;283;83;3;280;244;36
06.11.2022;Bürgerentscheid zur Abwahl des Oberbürgermeisters der Stadt Frankfurt am Main, Herrn Peter Feldmann;06412000;91001;910-01;1;1;523;141;32;696;207;42;1;206;183;23
06.11.2022;Bürgerentscheid zur Abwahl des Oberbürgermeisters der Stadt Frankfurt am Main, Herrn Peter Feldmann;06412000;91002;910-02;1;1;654;267;39;960;407;83;5;402;329;73
06.11.2022;Bürgerentscheid zur Abwahl des Oberbürgermeisters der Stadt Frankfurt am Main, Herrn Peter Feldmann;06412000;91003;910-03;1;1;800;227;63;1090;441;112;5;436;384;52
06.11.2022;Bürgerentscheid zur Abwahl des Oberbürgermeisters der Stadt Frankfurt am Main, Herrn Peter Feldmann;06412000;91101;911-01;1;1;526;172;32;730;179;44;2;177;148;29
06.11.2022;Bürgerentscheid zur Abwahl des Oberbürgermeisters der Stadt Frankfurt am Main, Herrn Peter Feldmann;06412000;91102;911-02;1;1;680;283;52;1015;437;133;4;433;363;70
06.11.2022;Bürgerentscheid zur Abwahl des Oberbürgermeisters der Stadt Frankfurt am Main, Herrn Peter Feldmann;06412000;91103;911-03;1;1;542;234;43;819;314;90;2;312;259;53
06.11.2022;Bürgerentscheid zur Abwahl des Oberbürgermeisters der Stadt Frankfurt am Main, Herrn Peter Feldmann;06412000;91104;911-04;1;1;664;271;60;995;345;81;3;342;293;49
06.11.2022;Bürgerentscheid zur Abwahl des Oberbürgermeisters der Stadt Frankfurt am Main, Herrn Peter Feldmann;06412000;91105;911-05;1;1;479;149;38;666;198;52;2;196;171;25
06.11.2022;Bürgerentscheid zur Abwahl des Oberbürgermeisters der Stadt Frankfurt am Main, Herrn Peter Feldmann;06412000;91106;911-06;1;1;532;152;26;710;204;50;1;203;168;35
06.11.2022;Bürgerentscheid zur Abwahl des Oberbürgermeisters der Stadt Frankfurt am Main, Herrn Peter Feldmann;06412000;91107;911-07;1;1;530;136;32;698;195;49;2;193;167;26
06.11.2022;Bürgerentscheid zur Abwahl des Oberbürgermeisters der Stadt Frankfurt am Main, Herrn Peter Feldmann;06412000;91108;911-08;1;1;743;261;41;1045;306;64;3;303;264;39
06.11.2022;Bürgerentscheid zur Abwahl des Oberbürgermeisters der Stadt Frankfurt am Main, Herrn Peter Feldmann;06412000;91201;912-01;1;1;490;197;33;720;191;50;1;190;169;21
06.11.2022;Bürgerentscheid zur Abwahl des Oberbürgermeisters der Stadt Frankfurt am Main, Herrn Peter Feldmann;06412000;91202;912-02;1;1;655;266;52;973;312;76;3;309;271;38
06.11.2022;Bürgerentscheid zur Abwahl des Oberbürgermeisters der Stadt Frankfurt am Main, Herrn Peter Feldmann;06412000;91203;912-03;1;1;716;182;50;948;361;110;4;357;311;46
06.11.2022;Bürgerentscheid zur Abwahl des Oberbürgermeisters der Stadt Frankfurt am Main, Herrn Peter Feldmann;06412000;91204;912-04;1;1;642;159;44;845;232;57;2;230;198;32
06.11.2022;Bürgerentscheid zur Abwahl des Oberbürgermeisters der Stadt Frankfurt am Main, Herrn Peter Feldmann;06412000;91205;912-05;1;1;517;154;36;707;275;57;2;273;241;32
06.11.2022;Bürgerentscheid zur Abwahl des Oberbürgermeisters der Stadt Frankfurt am Main, Herrn Peter Feldmann;06412000;91206;912-06;1;1;630;224;52;906;323;93;2;321;283;38
06.11.2022;Bürgerentscheid zur Abwahl des Oberbürgermeisters der Stadt Frankfurt am Main, Herrn Peter Feldmann;06412000;91207;912-07;1;1;699;256;57;1012;279;60;3;276;237;39
06.11.2022;Bürgerentscheid zur Abwahl des Oberbürgermeisters der Stadt Frankfurt am Main, Herrn Peter Feldmann;06412000;91208;912-08;1;1;496;172;37;705;258;51;2;256;210;46
06.11.2022;Bürgerentscheid zur Abwahl des Oberbürgermeisters der Stadt Frankfurt am Main, Herrn Peter Feldmann;06412000;91209;912-09;1;1;552;245;47;844;240;70;2;238;206;32
06.11.2022;Bürgerentscheid zur Abwahl des Oberbürgermeisters der Stadt Frankfurt am Main, Herrn Peter Feldmann;06412000;91210;912-10;1;1;692;264;56;1012;329;98;3;326;268;58
06.11.2022;Bürgerentscheid zur Abwahl des Oberbürgermeisters der Stadt Frankfurt am Main, Herrn Peter Feldmann;06412000;91211;912-11;1;1;517;223;38;778;225;58;2;223;190;33
06.11.2022;Bürgerentscheid zur Abwahl des Oberbürgermeisters der Stadt Frankfurt am Main, Herrn Peter Feldmann;06412000;91301;913-01;1;1;474;189;38;701;198;46;2;196;169;27
06.11.2022;Bürgerentscheid zur Abwahl des Oberbürgermeisters der Stadt Frankfurt am Main, Herrn Peter Feldmann;06412000;91302;913-02;1;1;682;205;35;922;318;60;3;315;268;47
06.11.2022;Bürgerentscheid zur Abwahl des Oberbürgermeisters der Stadt Frankfurt am Main, Herrn Peter Feldmann;06412000;91303;913-03;1;1;631;258;54;943;297;59;3;294;248;46
06.11.2022;Bürgerentscheid zur Abwahl des Oberbürgermeisters der Stadt Frankfurt am Main, Herrn Peter Feldmann;06412000;91304;913-04;1;1;597;248;46;891;381;85;3;378;314;64
06.11.2022;Bürgerentscheid zur Abwahl des Oberbürgermeisters der Stadt Frankfurt am Main, Herrn Peter Feldmann;06412000;91305;913-05;1;1;544;139;33;716;197;52;2;195;170;25
06.11.2022;Bürgerentscheid zur Abwahl des Oberbürgermeisters der Stadt Frankfurt am Main, Herrn Peter Feldmann;06412000;91306;913-06;1;1;516;126;26;668;210;45;2;208;184;24
06.11.2022;Bürgerentscheid zur Abwahl des Oberbürgermeisters der Stadt Frankfurt am Main, Herrn Peter Feldmann;06412000;91307;913-07;1;1;602;210;37;849;296;58;3;293;242;51
06.11.2022;Bürgerentscheid zur Abwahl des Oberbürgermeisters der Stadt Frankfurt am Main, Herrn Peter Feldmann;06412000;91308;913-08;1;1;639;282;47;968;298;84;3;295;250;45
06.11.2022;Bürgerentscheid zur Abwahl des Oberbürgermeisters der Stadt Frankfurt am Main, Herrn Peter Feldmann;06412000;91309;913-09;1;1;557;265;37;859;261;57;3;258;224;34
06.11.2022;Bürgerentscheid zur Abwahl des Oberbürgermeisters der Stadt Frankfurt am Main, Herrn Peter Feldmann;06412000;91310;913-10;1;1;609;255;56;920;322;98;3;319;282;37
06.11.2022;Bürgerentscheid zur Abwahl des Oberbürgermeisters der Stadt Frankfurt am Main, Herrn Peter Feldmann;06412000;91401;914-01;1;1;715;240;53;1008;427;120;3;424;345;79
06.11.2022;Bürgerentscheid zur Abwahl des Oberbürgermeisters der Stadt Frankfurt am Main, Herrn Peter Feldmann;06412000;91402;914-02;1;1;673;324;44;1041;311;85;3;308;254;54
06.11.2022;Bürgerentscheid zur Abwahl des Oberbürgermeisters der Stadt Frankfurt am Main, Herrn Peter Feldmann;06412000;91403;914-03;1;1;640;174;48;862;316;78;2;314;267;47
06.11.2022;Bürgerentscheid zur Abwahl des Oberbürgermeisters der Stadt Frankfurt am Main, Herrn Peter Feldmann;06412000;91404;914-04;1;1;529;173;42;744;220;51;2;218;187;31
06.11.2022;Bürgerentscheid zur Abwahl des Oberbürgermeisters der Stadt Frankfurt am Main, Herrn Peter Feldmann;06412000;91405;914-05;1;1;634;256;40;930;292;83;3;289;254;35
06.11.2022;Bürgerentscheid zur Abwahl des Oberbürgermeisters der Stadt Frankfurt am Main, Herrn Peter Feldmann;06412000;91406;914-06;1;1;537;174;35;746;215;56;2;213;183;30
06.11.2022;Bürgerentscheid zur Abwahl des Oberbürgermeisters der Stadt Frankfurt am Main, Herrn Peter Feldmann;06412000;91407;914-07;1;1;841;213;53;1107;423;123;4;419;355;64
06.11.2022;Bürgerentscheid zur Abwahl des Oberbürgermeisters der Stadt Frankfurt am Main, Herrn Peter Feldmann;06412000;91408;914-08;1;1;516;201;41;758;227;65;2;225;197;28
06.11.2022;Bürgerentscheid zur Abwahl des Oberbürgermeisters der Stadt Frankfurt am Main, Herrn Peter Feldmann;06412000;91409;914-09;1;1;696;324;54;1074;364;94;4;360;298;62
06.11.2022;Bürgerentscheid zur Abwahl des Oberbürgermeisters der Stadt Frankfurt am Main, Herrn Peter Feldmann;06412000;91601;916-01;1;1;464;179;41;684;237;52;1;236;209;27
06.11.2022;Bürgerentscheid zur Abwahl des Oberbürgermeisters der Stadt Frankfurt am Main, Herrn Peter Feldmann;06412000;91602;916-02;1;1;649;301;38;988;248;71;2;246;218;28
06.11.2022;Bürgerentscheid zur Abwahl des Oberbürgermeisters der Stadt Frankfurt am Main, Herrn Peter Feldmann;06412000;91603;916-03;1;1;453;207;39;699;194;54;1;193;168;25
06.11.2022;Bürgerentscheid zur Abwahl des Oberbürgermeisters der Stadt Frankfurt am Main, Herrn Peter Feldmann;06412000;91701;917-01;1;1;538;162;40;740;205;54;2;203;179;24
06.11.2022;Bürgerentscheid zur Abwahl des Oberbürgermeisters der Stadt Frankfurt am Main, Herrn Peter Feldmann;06412000;91702;917-02;1;1;748;208;54;1010;296;65;3;293;242;51
06.11.2022;Bürgerentscheid zur Abwahl des Oberbürgermeisters der Stadt Frankfurt am Main, Herrn Peter Feldmann;06412000;91703;917-03;1;1;609;231;54;894;207;59;2;205;174;31
06.11.2022;Bürgerentscheid zur Abwahl des Oberbürgermeisters der Stadt Frankfurt am Main, Herrn Peter Feldmann;06412000;91704;917-04;1;1;595;245;43;883;279;76;3;276;245;31
06.11.2022;Bürgerentscheid zur Abwahl des Oberbürgermeisters der Stadt Frankfurt am Main, Herrn Peter Feldmann;06412000;91705;917-05;1;1;615;226;34;875;362;106;4;358;300;58
06.11.2022;Bürgerentscheid zur Abwahl des Oberbürgermeisters der Stadt Frankfurt am Main, Herrn Peter Feldmann;06412000;91706;917-06;1;1;669;173;55;897;341;79;3;338;293;45
06.11.2022;Bürgerentscheid zur Abwahl des Oberbürgermeisters der Stadt Frankfurt am Main, Herrn Peter Feldmann;06412000;91801;918-01;1;1;556;162;31;749;272;69;2;270;225;45
06.11.2022;Bürgerentscheid zur Abwahl des Oberbürgermeisters der Stadt Frankfurt am Main, Herrn Peter Feldmann;06412000;91802;918-02;1;1;599;280;40;919;330;101;3;327;281;46
06.11.2022;Bürgerentscheid zur Abwahl des Oberbürgermeisters der Stadt Frankfurt am Main, Herrn Peter Feldmann;06412000;91803;918-03;1;1;588;282;39;909;332;77;2;330;291;39
06.11.2022;Bürgerentscheid zur Abwahl des Oberbürgermeisters der Stadt Frankfurt am Main, Herrn Peter Feldmann;06412000;91804;918-04;1;1;591;269;33;893;329;95;3;326;285;41
06.11.2022;Bürgerentscheid zur Abwahl des Oberbürgermeisters der Stadt Frankfurt am Main, Herrn Peter Feldmann;06412000;91805;918-05;1;1;662;244;48;954;287;88;2;285;246;39
06.11.2022;Bürgerentscheid zur Abwahl des Oberbürgermeisters der Stadt Frankfurt am Main, Herrn Peter Feldmann;06412000;91806;918-06;1;1;626;243;38;907;299;82;3;296;262;34
06.11.2022;Bürgerentscheid zur Abwahl des Oberbürgermeisters der Stadt Frankfurt am Main, Herrn Peter Feldmann;06412000;91901;919-01;1;1;661;218;51;930;252;75;2;250;205;45
06.11.2022;Bürgerentscheid zur Abwahl des Oberbürgermeisters der Stadt Frankfurt am Main, Herrn Peter Feldmann;06412000;91902;919-02;1;1;631;162;48;841;325;62;2;323;285;38
06.11.2022;Bürgerentscheid zur Abwahl des Oberbürgermeisters der Stadt Frankfurt am Main, Herrn Peter Feldmann;06412000;91903;919-03;1;1;622;183;44;849;201;47;2;199;165;34
06.11.2022;Bürgerentscheid zur Abwahl des Oberbürgermeisters der Stadt Frankfurt am Main, Herrn Peter Feldmann;06412000;91904;919-04;1;1;663;207;48;918;311;75;2;309;273;36
06.11.2022;Bürgerentscheid zur Abwahl des Oberbürgermeisters der Stadt Frankfurt am Main, Herrn Peter Feldmann;06412000;91905;919-05;1;1;487;223;32;742;199;49;1;198;169;29
06.11.2022;Bürgerentscheid zur Abwahl des Oberbürgermeisters der Stadt Frankfurt am Main, Herrn Peter Feldmann;06412000;92001;920-01;1;1;516;139;39;694;252;48;3;249;204;45
06.11.2022;Bürgerentscheid zur Abwahl des Oberbürgermeisters der Stadt Frankfurt am Main, Herrn Peter Feldmann;06412000;92002;920-02;1;1;676;242;50;968;322;100;2;320;282;38
06.11.2022;Bürgerentscheid zur Abwahl des Oberbürgermeisters der Stadt Frankfurt am Main, Herrn Peter Feldmann;06412000;92003;920-03;1;1;734;215;39;988;312;60;3;309;254;55
06.11.2022;Bürgerentscheid zur Abwahl des Oberbürgermeisters der Stadt Frankfurt am Main, Herrn Peter Feldmann;06412000;92004;920-04;1;1;716;315;42;1073;300;59;3;297;248;49
06.11.2022;Bürgerentscheid zur Abwahl des Oberbürgermeisters der Stadt Frankfurt am Main, Herrn Peter Feldmann;06412000;92005;920-05;1;1;532;222;38;792;294;68;3;291;253;38
06.11.2022;Bürgerentscheid zur Abwahl des Oberbürgermeisters der Stadt Frankfurt am Main, Herrn Peter Feldmann;06412000;92101;921-01;1;1;739;232;38;1009;269;63;2;267;229;38
06.11.2022;Bürgerentscheid zur Abwahl des Oberbürgermeisters der Stadt Frankfurt am Main, Herrn Peter Feldmann;06412000;92102;921-02;1;1;588;172;40;800;271;75;3;268;231;37
06.11.2022;Bürgerentscheid zur Abwahl des Oberbürgermeisters der Stadt Frankfurt am Main, Herrn Peter Feldmann;06412000;92201;922-01;1;1;705;198;44;947;384;99;3;381;339;42
06.11.2022;Bürgerentscheid zur Abwahl des Oberbürgermeisters der Stadt Frankfurt am Main, Herrn Peter Feldmann;06412000;92202;922-02;1;1;487;225;46;758;232;63;1;231;193;38
06.11.2022;Bürgerentscheid zur Abwahl des Oberbürgermeisters der Stadt Frankfurt am Main, Herrn Peter Feldmann;06412000;92203;922-03;1;1;586;151;44;781;227;50;2;225;197;28
06.11.2022;Bürgerentscheid zur Abwahl des Oberbürgermeisters der Stadt Frankfurt am Main, Herrn Peter Feldmann;06412000;92204;922-04;1;1;707;298;50;1055;358;69;3;355;306;49
06.11.2022;Bürgerentscheid zur Abwahl des Oberbürgermeisters der Stadt Frankfurt am Main, Herrn Peter Feldmann;06412000;92205;922-05;1;1;531;228;39;798;298;65;2;296;262;34
06.11.2022;Bürgerentscheid zur Abwahl des Oberbürgermeisters der Stadt Frankfurt am Main, Herrn Peter Feldmann;06412000;92401;924-01;1;1;615;217;51;883;218;50;2;216;190;26
06.11.2022;Bürgerentscheid zur Abwahl des Oberbürgermeisters der Stadt Frankfurt am Main, Herrn Peter Feldmann;06412000;92402;924-02;1;1;483;166;40;689;237;68;2;235;196;39
06.11.2022;Bürgerentscheid zur Abwahl des Oberbürgermeisters der Stadt Frankfurt am Main, Herrn Peter Feldmann;06412000;92403;924-03;1;1;634;222;37;893;225;52;2;223;192;31
06.11.2022;Bürgerentscheid zur Abwahl des Oberbürgermeisters der Stadt Frankfurt am Main, Herrn Peter Feldmann;06412000;92404;924-04;1;1;633;188;38;859;242;47;2;240;213;27
06.11.2022;Bürgerentscheid zur Abwahl des Oberbürgermeisters der Stadt Frankfurt am Main, Herrn Peter Feldmann;06412000;92405;924-05;1;1;513;176;41;730;275;73;2;273;224;49
06.11.2022;Bürgerentscheid zur Abwahl des Oberbürgermeisters der Stadt Frankfurt am Main, Herrn Peter Feldmann;06412000;92501;925-01;1;1;586;154;48;788;218;51;2;216;182;34
06.11.2022;Bürgerentscheid zur Abwahl des Oberbürgermeisters der Stadt Frankfurt am Main, Herrn Peter Feldmann;06412000;92502;925-02;1;1;660;182;52;894;220;50;1;219;187;32
06.11.2022;Bürgerentscheid zur Abwahl des Oberbürgermeisters der Stadt Frankfurt am Main, Herrn Peter Feldmann;06412000;92503;925-03;1;1;622;290;46;958;351;83;2;349;288;61
06.11.2022;Bürgerentscheid zur Abwahl des Oberbürgermeisters der Stadt Frankfurt am Main, Herrn Peter Feldmann;06412000;92504;925-04;1;1;519;153;29;701;246;64;2;244;201;43
06.11.2022;Bürgerentscheid zur Abwahl des Oberbürgermeisters der Stadt Frankfurt am Main, Herrn Peter Feldmann;06412000;92601;926-01;1;1;596;155;31;782;186;48;1;185;158;27
06.11.2022;Bürgerentscheid zur Abwahl des Oberbürgermeisters der Stadt Frankfurt am Main, Herrn Peter Feldmann;06412000;92602;926-02;1;1;717;277;63;1057;338;99;3;335;281;54
06.11.2022;Bürgerentscheid zur Abwahl des Oberbürgermeisters der Stadt Frankfurt am Main, Herrn Peter Feldmann;06412000;92603;926-03;1;1;735;181;44;960;292;87;3;289;242;47
06.11.2022;Bürgerentscheid zur Abwahl des Oberbürgermeisters der Stadt Frankfurt am Main, Herrn Peter Feldmann;06412000;92604;926-04;1;1;586;149;43;778;338;95;3;335;274;61
06.11.2022;Bürgerentscheid zur Abwahl des Oberbürgermeisters der Stadt Frankfurt am Main, Herrn Peter Feldmann;06412000;92701;927-01;1;1;558;258;44;860;323;72;3;320;284;36
06.11.2022;Bürgerentscheid zur Abwahl des Oberbürgermeisters der Stadt Frankfurt am Main, Herrn Peter Feldmann;06412000;92702;927-02;1;1;574;239;41;854;312;82;2;310;274;36
06.11.2022;Bürgerentscheid zur Abwahl des Oberbürgermeisters der Stadt Frankfurt am Main, Herrn Peter Feldmann;06412000;92703;927-03;1;1;465;169;36;670;235;48;2;233;200;33
06.11.2022;Bürgerentscheid zur Abwahl des Oberbürgermeisters der Stadt Frankfurt am Main, Herrn Peter Feldmann;06412000;92704;927-04;1;1;592;254;34;880;297;77;3;294;243;51
06.11.2022;Bürgerentscheid zur Abwahl des Oberbürgermeisters der Stadt Frankfurt am Main, Herrn Peter Feldmann;06412000;92705;927-05;1;1;571;237;36;844;217;63;1;216;176;40
06.11.2022;Bürgerentscheid zur Abwahl des Oberbürgermeisters der Stadt Frankfurt am Main, Herrn Peter Feldmann;06412000;92706;927-06;1;1;514;213;39;766;215;44;1;214;186;28
06.11.2022;Bürgerentscheid zur Abwahl des Oberbürgermeisters der Stadt Frankfurt am Main, Herrn Peter Feldmann;06412000;92801;928-01;1;1;665;266;47;978;323;85;3;320;266;54
06.11.2022;Bürgerentscheid zur Abwahl des Oberbürgermeisters der Stadt Frankfurt am Main, Herrn Peter Feldmann;06412000;92802;928-02;1;1;643;255;51;949;253;77;2;251;223;28
06.11.2022;Bürgerentscheid zur Abwahl des Oberbürgermeisters der Stadt Frankfurt am Main, Herrn Peter Feldmann;06412000;92803;928-03;1;1;478;178;26;682;240;48;2;238;198;40
06.11.2022;Bürgerentscheid zur Abwahl des Oberbürgermeisters der Stadt Frankfurt am Main, Herrn Peter Feldmann;06412000;92804;928-04;1;1;584;288;51;923;228;43;2;226;191;35
06.11.2022;Bürgerentscheid zur Abwahl des Oberbürgermeisters der Stadt Frankfurt am Main, Herrn Peter Feldmann;06412000;92901;929-01;1;1;470;159;36;665;225;69;2;223;187;36
06.11.2022;Bürgerentscheid zur Abwahl des Oberbürgermeisters der Stadt Frankfurt am Main, Herrn Peter Feldmann;06412000;92902;929-02;1;1;758;217;40;1015;328;91;2;326;287;39
06.11.2022;Bürgerentscheid zur Abwahl des Oberbürgermeisters der Stadt Frankfurt am Main, Herrn Peter Feldmann;06412000;92903;929-03;1;1;690;245;38;973;352;66;4;348;295;53
06.11.2022;Bürgerentscheid zur Abwahl des Oberbürgermeisters der Stadt Frankfurt am Main, Herrn Peter Feldmann;06412000;92904;929-04;1;1;647;212;54;913;343;67;3;340;281;59
06.11.2022;Bürgerentscheid zur Abwahl des Oberbürgermeisters der Stadt Frankfurt am Main, Herrn Peter Feldmann;06412000;93001;930-01;1;1;772;232;41;1045;405;112;4;401;356;45
06.11.2022;Bürgerentscheid zur Abwahl des Oberbürgermeisters der Stadt Frankfurt am Main, Herrn Peter Feldmann;06412000;93002;930-02;1;1;690;251;39;980;291;69;3;288;248;40
06.11.2022;Bürgerentscheid zur Abwahl des Oberbürgermeisters der Stadt Frankfurt am Main, Herrn Peter Feldmann;06412000;93003;930-03;1;1;744;200;37;981;256;63;2;254;218;36
06.11.2022;Bürgerentscheid zur Abwahl des Oberbürgermeisters der Stadt Frankfurt am Main, Herrn Peter Feldmann;06412000;93004;930-04;1;1;644;303;38;985;386;114;3;383;331;52
06.11.2022;Bürgerentscheid zur Abwahl des Oberbürgermeisters der Stadt Frankfurt am Main, Herrn Peter Feldmann;06412000;93101;931-01;1;1;582;190;49;821;292;90;2;290;252;38
06.11.2022;Bürgerentscheid zur Abwahl des Oberbürgermeisters der Stadt Frankfurt am Main, Herrn Peter Feldmann;06412000;93102;931-02;1;1;525;176;41;742;224;52;2;222;196;26
06.11.2022;Bürgerentscheid zur Abwahl des Oberbürgermeisters der Stadt Frankfurt am Main, Herrn Peter Feldmann;06412000;93201;932-01;1;1;506;156;37;699;172;39;1;171;146;25
06.11.2022;Bürgerentscheid zur Abwahl des Oberbürgermeisters der Stadt Frankfurt am Main, Herrn Peter Feldmann;06412000;93301;933-01;1;1;600;223;39;862;221;65;2;219;183;36
06.11.2022;Bürgerentscheid zur Abwahl des Oberbürgermeisters der Stadt Frankfurt am Main, Herrn Peter Feldmann;06412000;93401;934-01;1;1;570;253;41;864;345;79;2;343;294;49
06.11.2022;Bürgerentscheid zur Abwahl des Oberbürgermeisters der Stadt Frankfurt am Main, Herrn Peter Feldmann;06412000;93402;934-02;1;1;693;227;51;971;235;50;2;233;190;43
06.11.2022;Bürgerentscheid zur Abwahl des Oberbürgermeisters der Stadt Frankfurt am Main, Herrn Peter Feldmann;06412000;93403;934-03;1;1;541;137;31;709;257;64;2;255;225;30
06.11.2022;Bürgerentscheid zur Abwahl des Oberbürgermeisters der Stadt Frankfurt am Main, Herrn Peter Feldmann;06412000;93501;935-01;1;1;521;153;39;713;243;63;1;242;211;31
06.11.2022;Bürgerentscheid zur Abwahl des Oberbürgermeisters der Stadt Frankfurt am Main, Herrn Peter Feldmann;06412000;93502;935-02;1;1;633;207;40;880;322;86;2;320;262;58
06.11.2022;Bürgerentscheid zur Abwahl des Oberbürgermeisters der Stadt Frankfurt am Main, Herrn Peter Feldmann;06412000;93503;935-03;1;1;544;152;39;735;211;49;2;209;176;33
06.11.2022;Bürgerentscheid zur Abwahl des Oberbürgermeisters der Stadt Frankfurt am Main, Herrn Peter Feldmann;06412000;93504;935-04;1;1;687;199;53;939;295;61;3;292;245;47
06.11.2022;Bürgerentscheid zur Abwahl des Oberbürgermeisters der Stadt Frankfurt am Main, Herrn Peter Feldmann;06412000;93601;936-01;1;1;726;220;62;1008;289;90;2;287;249;38
06.11.2022;Bürgerentscheid zur Abwahl des Oberbürgermeisters der Stadt Frankfurt am Main, Herrn Peter Feldmann;06412000;93602;936-02;1;1;555;212;51;818;324;76;3;321;270;51
06.11.2022;Bürgerentscheid zur Abwahl des Oberbürgermeisters der Stadt Frankfurt am Main, Herrn Peter Feldmann;06412000;93603;936-03;1;1;626;270;52;948;317;86;3;314;277;37
06.11.2022;Bürgerentscheid zur Abwahl des Oberbürgermeisters der Stadt Frankfurt am Main, Herrn Peter Feldmann;06412000;93701;937-01;1;1;715;329;63;1107;350;67;3;347;289;58
06.11.2022;Bürgerentscheid zur Abwahl des Oberbürgermeisters der Stadt Frankfurt am Main, Herrn Peter Feldmann;06412000;93702;937-02;1;1;590;243;49;882;295;86;3;292;242;50
06.11.2022;Bürgerentscheid zur Abwahl des Oberbürgermeisters der Stadt Frankfurt am Main, Herrn Peter Feldmann;06412000;93703;937-03;1;1;480;209;31;720;261;75;3;258;223;35
06.11.2022;Bürgerentscheid zur Abwahl des Oberbürgermeisters der Stadt Frankfurt am Main, Herrn Peter Feldmann;06412000;93704;937-04;1;1;615;216;43;874;254;63;2;252;208;44
06.11.2022;Bürgerentscheid zur Abwahl des Oberbürgermeisters der Stadt Frankfurt am Main, Herrn Peter Feldmann;06412000;93801;938-01;1;1;532;200;42;774;207;49;2;205;180;25
06.11.2022;Bürgerentscheid zur Abwahl des Oberbürgermeisters der Stadt Frankfurt am Main, Herrn Peter Feldmann;06412000;93802;938-02;1;1;719;273;41;1033;434;109;3;431;379;52
06.11.2022;Bürgerentscheid zur Abwahl des Oberbürgermeisters der Stadt Frankfurt am Main, Herrn Peter Feldmann;06412000;93901;939-01;1;1;780;197;57;1034;421;119;3;418;354;64
06.11.2022;Bürgerentscheid zur Abwahl des Oberbürgermeisters der Stadt Frankfurt am Main, Herrn Peter Feldmann;06412000;93902;939-02;1;1;692;239;59;990;361;111;3;358;314;44
06.11.2022;Bürgerentscheid zur Abwahl des Oberbürgermeisters der Stadt Frankfurt am Main, Herrn Peter Feldmann;06412000;93903;939-03;1;1;780;218;43;1041;361;98;3;358;310;48
06.11.2022;Bürgerentscheid zur Abwahl des Oberbürgermeisters der Stadt Frankfurt am Main, Herrn Peter Feldmann;06412000;94001;940-01;1;1;459;186;36;681;160;38;1;159;141;18
06.11.2022;Bürgerentscheid zur Abwahl des Oberbürgermeisters der Stadt Frankfurt am Main, Herrn Peter Feldmann;06412000;94002;940-02;1;1;718;222;58;998;320;97;3;317;270;47
06.11.2022;Bürgerentscheid zur Abwahl des Oberbürgermeisters der Stadt Frankfurt am Main, Herrn Peter Feldmann;06412000;94003;940-03;1;1;559;226;47;832;235;64;2;233;195;38
06.11.2022;Bürgerentscheid zur Abwahl des Oberbürgermeisters der Stadt Frankfurt am Main, Herrn Peter Feldmann;06412000;94004;940-04;1;1;587;218;49;854;353;67;3;350;295;55
06.11.2022;Bürgerentscheid zur Abwahl des Oberbürgermeisters der Stadt Frankfurt am Main, Herrn Peter Feldmann;06412000;94101;941-01;1;1;750;230;53;1033;397;99;3;394;335;59
06.11.2022;Bürgerentscheid zur Abwahl des Oberbürgermeisters der Stadt Frankfurt am Main, Herrn Peter Feldmann;06412000;94102;941-02;1;1;503;220;45;768;250;63;2;248;203;45
06.11.2022;Bürgerentscheid zur Abwahl des Oberbürgermeisters der Stadt Frankfurt am Main, Herrn Peter Feldmann;06412000;94103;941-03;1;1;475;212;33;720;234;67;2;232;195;37
06.11.2022;Bürgerentscheid zur Abwahl des Oberbürgermeisters der Stadt Frankfurt am Main, Herrn Peter Feldmann;06412000;94104;941-04;1;1;739;209;42;990;330;72;3;327;266;61
06.11.2022;Bürgerentscheid zur Abwahl des Oberbürgermeisters der Stadt Frankfurt am Main, Herrn Peter Feldmann;06412000;94201;942-01;1;1;566;146;37;749;257;49;3;254;221;33
06.11.2022;Bürgerentscheid zur Abwahl des Oberbürgermeisters der Stadt Frankfurt am Main, Herrn Peter Feldmann;06412000;94202;942-02;1;1;519;150;44;713;270;59;2;268;228;40
06.11.2022;Bürgerentscheid zur Abwahl des Oberbürgermeisters der Stadt Frankfurt am Main, Herrn Peter Feldmann;06412000;94301;943-01;1;1;483;203;27;713;218;42;2;216;177;39
06.11.2022;Bürgerentscheid zur Abwahl des Oberbürgermeisters der Stadt Frankfurt am Main, Herrn Peter Feldmann;06412000;94302;943-02;1;1;621;250;44;915;326;78;3;323;280;43
06.11.2022;Bürgerentscheid zur Abwahl des Oberbürgermeisters der Stadt Frankfurt am Main, Herrn Peter Feldmann;06412000;94303;943-03;1;1;650;261;41;952;370;86;2;368;304;64
06.11.2022;Bürgerentscheid zur Abwahl des Oberbürgermeisters der Stadt Frankfurt am Main, Herrn Peter Feldmann;06412000;94304;943-04;1;1;622;175;51;848;216;55;1;215;185;30
06.11.2022;Bürgerentscheid zur Abwahl des Oberbürgermeisters der Stadt Frankfurt am Main, Herrn Peter Feldmann;06412000;94305;943-05;1;1;645;228;57;930;245;47;2;243;208;35
06.11.2022;Bürgerentscheid zur Abwahl des Oberbürgermeisters der Stadt Frankfurt am Main, Herrn Peter Feldmann;06412000;94401;944-01;1;1;666;212;42;920;236;68;2;234;204;30
06.11.2022;Bürgerentscheid zur Abwahl des Oberbürgermeisters der Stadt Frankfurt am Main, Herrn Peter Feldmann;06412000;94402;944-02;1;1;520;202;30;752;322;69;3;319;265;54
06.11.2022;Bürgerentscheid zur Abwahl des Oberbürgermeisters der Stadt Frankfurt am Main, Herrn Peter Feldmann;06412000;94501;945-01;1;1;759;190;40;989;346;75;2;344;281;63
06.11.2022;Bürgerentscheid zur Abwahl des Oberbürgermeisters der Stadt Frankfurt am Main, Herrn Peter Feldmann;06412000;94502;945-02;1;1;633;273;53;959;275;58;2;273;238;35
06.11.2022;Bürgerentscheid zur Abwahl des Oberbürgermeisters der Stadt Frankfurt am Main, Herrn Peter Feldmann;06412000;94503;945-03;1;1;742;287;66;1095;361;90;4;357;304;53
06.11.2022;Bürgerentscheid zur Abwahl des Oberbürgermeisters der Stadt Frankfurt am Main, Herrn Peter Feldmann;06412000;94601;946-01;1;1;619;296;51;966;335;72;3;332;270;62
06.11.2022;Bürgerentscheid zur Abwahl des Oberbürgermeisters der Stadt Frankfurt am Main, Herrn Peter Feldmann;06412000;94602;946-02;1;1;683;297;55;1035;271;53;3;268;222;46
06.11.2022;Bürgerentscheid zur Abwahl des Oberbürgermeisters der Stadt Frankfurt am Main, Herrn Peter Feldmann;06412000;94603;946-03;1;1;671;220;37;928;311;72;3;308;270;38
06.11.2022;Bürgerentscheid zur Abwahl des Oberbürgermeisters der Stadt Frankfurt am Main, Herrn Peter Feldmann;06412000;94604;946-04;1;1;826;223;51;1100;397;107;3;394;327;67
06.11.2022;Bürgerentscheid zur Abwahl des Oberbürgermeisters der Stadt Frankfurt am Main, Herrn Peter Feldmann;06412000;94605;946-05;1;1;764;191;51;1006;278;68;2;276;243;33
06.11.2022;Bürgerentscheid zur Abwahl des Oberbürgermeisters der Stadt Frankfurt am Main, Herrn Peter Feldmann;06412000;94701;947-01;1;1;553;242;47;842;332;80;2;330;278;52
06.11.2022;Bürgerentscheid zur Abwahl des Oberbürgermeisters der Stadt Frankfurt am Main, Herrn Peter Feldmann;06412000;94702;947-02;1;1;594;253;41;888;304;70;2;302;249;53
